연도,시군구별,연료별,용도별,승용,승합,화물,특수,계
2005,종로구,CNG,비사업용,0,3,2,0,5
2005,종로구,CNG,사업용,0,77,0,0,77
2005,종로구,경유,비사업용,6938,3297,6039,58,16332
2005,종로구,경유,사업용,1224,819,390,59,2492
2005,종로구,기타연료,비사업용,5,8,4,2,19
2005,종로구,기타연료,사업용,0,1,79,0,80
2005,종로구,엘피지,비사업용,2251,1229,578,0,4058
2005,종로구,엘피지,사업용,2624,3,57,0,2684
2005,종로구,휘발유,비사업용,9536,28,45,0,9609
2005,종로구,휘발유,사업용,3683,5,0,0,3688
2005,종로구,휘발유(무연),비사업용,23971,93,50,0,24114
2005,종로구,휘발유(무연),사업용,2663,0,0,0,2663
2005,종로구,휘발유(유연),비사업용,2,0,0,0,2
2005,중구,CNG,비사업용,0,4,1,0,5
2005,중구,CNG,사업용,0,7,0,0,7
2005,중구,경유,비사업용,6425,2563,6033,84,15105
2005,중구,경유,사업용,145,153,1066,65,1429
2005,중구,기타연료,비사업용,8,0,15,8,31
2005,중구,기타연료,사업용,0,0,133,0,133
2005,중구,엘피지,비사업용,2026,1241,572,1,3840
2005,중구,엘피지,사업용,379,4,92,0,475
2005,중구,휘발유,비사업용,8258,20,25,0,8303
2005,중구,휘발유,사업용,257,1,0,0,258
2005,중구,휘발유(무연),비사업용,20400,81,46,0,20527
2005,중구,휘발유(무연),사업용,262,0,0,0,262
2005,중구,휘발유(유연),비사업용,1,0,0,0,1
2005,용산구,CNG,비사업용,0,2,6,0,8
2005,용산구,경유,비사업용,7899,2704,7692,23,18318
2005,용산구,경유,사업용,19,141,998,41,1199
2005,용산구,기타연료,비사업용,1253,4,47,1,1305
2005,용산구,기타연료,사업용,0,0,42,1,43
2005,용산구,등유,비사업용,1,1,0,0,2
2005,용산구,엘피지,비사업용,3135,1740,743,0,5618
2005,용산구,엘피지,사업용,784,2,90,0,876
2005,용산구,휘발유,비사업용,11400,25,58,0,11483
2005,용산구,휘발유,사업용,86,0,0,0,86
2005,용산구,휘발유(무연),비사업용,32244,125,85,0,32454
2005,용산구,휘발유(무연),사업용,99,0,0,0,99
2005,용산구,휘발유(유연),비사업용,6,0,0,0,6
2005,성동구,CNG,비사업용,0,1,0,0,1
2005,성동구,CNG,사업용,0,23,0,0,23
2005,성동구,경유,비사업용,11442,3500,11126,44,26112
2005,성동구,경유,사업용,25,297,1616,64,2002
2005,성동구,기타연료,비사업용,6,0,6,0,12
2005,성동구,기타연료,사업용,0,0,34,0,34
2005,성동구,엘피지,비사업용,5316,2402,1076,0,8794
2005,성동구,엘피지,사업용,2347,0,314,2,2663
2005,성동구,휘발유,비사업용,9794,14,31,2,9841
2005,성동구,휘발유,사업용,69,0,0,0,69
2005,성동구,휘발유(무연),비사업용,38276,71,63,1,38411
2005,성동구,휘발유(무연),사업용,69,0,0,0,69
2005,성동구,휘발유(유연),비사업용,2,0,0,0,2
2005,광진구,CNG,비사업용,0,1,0,0,1
2005,광진구,경유,비사업용,11901,3972,10508,27,26408
2005,광진구,경유,사업용,15,224,1069,14,1322
2005,광진구,기타연료,비사업용,4,0,3,1,8
2005,광진구,엘피지,비사업용,5484,2654,1056,0,9194
2005,광진구,엘피지,사업용,2088,0,202,0,2290
2005,광진구,휘발유,비사업용,10234,14,35,0,10283
2005,광진구,휘발유,사업용,3,0,0,0,3
2005,광진구,휘발유(무연),비사업용,40344,79,58,0,40481
2005,광진구,휘발유(무연),사업용,10,0,2,0,12
2005,광진구,휘발유(유연),비사업용,1,0,0,0,1
2005,동대문구,CNG,비사업용,0,1,4,0,5
2005,동대문구,경유,비사업용,11793,4117,11702,44,27656
2005,동대문구,경유,사업용,6,174,1989,20,2189
2005,동대문구,기타연료,비사업용,4,2,3,2,11
2005,동대문구,기타연료,사업용,0,0,8,0,8
2005,동대문구,엘피지,비사업용,5761,2643,1299,0,9703
2005,동대문구,엘피지,사업용,2539,0,334,1,2874
2005,동대문구,휘발유,비사업용,9620,13,41,0,9674
2005,동대문구,휘발유,사업용,4,0,0,0,4
2005,동대문구,휘발유(무연),비사업용,35678,71,61,0,35810
2005,동대문구,휘발유(무연),사업용,19,0,0,0,19
2005,동대문구,휘발유(유연),비사업용,1,0,0,0,1
2005,중랑구,CNG,비사업용,0,0,2,0,2
2005,중랑구,CNG,사업용,0,364,0,0,364
2005,중랑구,경유,비사업용,12339,4760,12925,36,30060
2005,중랑구,경유,사업용,44,630,2261,94,3029
2005,중랑구,기타연료,비사업용,4,1,2,1,8
2005,중랑구,기타연료,사업용,0,35,4,0,39
2005,중랑구,엘피지,비사업용,6937,3029,1446,0,11412
2005,중랑구,엘피지,사업용,5413,0,365,7,5785
2005,중랑구,전기,비사업용,0,1,0,0,1
2005,중랑구,휘발유,비사업용,10076,25,34,0,10135
2005,중랑구,휘발유,사업용,33,0,0,0,33
2005,중랑구,휘발유(무연),비사업용,38434,96,59,0,38589
2005,중랑구,휘발유(무연),사업용,17,0,1,0,18
2005,중랑구,휘발유(유연),비사업용,1,0,0,0,1
2005,성북구,CNG,비사업용,1,1,0,0,2
2005,성북구,CNG,사업용,0,223,0,0,223
2005,성북구,경유,비사업용,13882,4566,10425,29,28902
2005,성북구,경유,사업용,46,657,1446,2,2151
2005,성북구,기타연료,비사업용,5,1,8,1,15
2005,성북구,기타연료,사업용,0,19,0,0,19
2005,성북구,엘피지,비사업용,7032,3121,1218,0,11371
2005,성북구,엘피지,사업용,2798,0,316,0,3114
2005,성북구,휘발유,비사업용,11230,20,37,0,11287
2005,성북구,휘발유,사업용,10,0,0,0,10
2005,성북구,휘발유(무연),비사업용,45152,100,60,0,45312
2005,성북구,휘발유(무연),사업용,16,0,1,0,17
2005,성북구,휘발유(유연),비사업용,3,0,0,0,3
2005,강북구,CNG,비사업용,0,0,2,0,2
2005,강북구,CNG,사업용,0,57,0,0,57
2005,강북구,경유,비사업용,9020,3522,8434,18,20994
2005,강북구,경유,사업용,37,706,1213,4,1960
2005,강북구,기타연료,비사업용,0,0,1,0,1
2005,강북구,기타연료,사업용,0,4,0,0,4
2005,강북구,알코올,비사업용,0,0,1,0,1
2005,강북구,엘피지,비사업용,5568,2394,1102,0,9064
2005,강북구,엘피지,사업용,2669,4,303,0,2976
2005,강북구,휘발유,비사업용,7464,14,27,0,7505
2005,강북구,휘발유,사업용,8,0,0,0,8
2005,강북구,휘발유(무연),비사업용,29317,63,41,0,29421
2005,강북구,휘발유(무연),사업용,8,0,2,0,10
2005,강북구,휘발유(유연),비사업용,2,0,0,0,2
2005,도봉구,CNG,비사업용,0,5,0,0,5
2005,도봉구,CNG,사업용,0,285,0,0,285
2005,도봉구,경유,비사업용,11673,3878,9395,17,24963
2005,도봉구,경유,사업용,27,277,1128,29,1461
2005,도봉구,기타연료,비사업용,2,0,7,1,10
2005,도봉구,기타연료,사업용,0,0,3,0,3
2005,도봉구,엘피지,비사업용,6394,2819,1025,0,10238
2005,도봉구,엘피지,사업용,5568,2,221,0,5791
2005,도봉구,휘발유,비사업용,9232,14,20,0,9266
2005,도봉구,휘발유,사업용,9,0,0,0,9
2005,도봉구,휘발유(무연),비사업용,41144,76,57,0,41277
2005,도봉구,휘발유(무연),사업용,10,0,2,0,12
2005,도봉구,휘발유(유연),비사업용,2,0,0,0,2
2005,노원구,CNG,비사업용,2,0,0,0,2
2005,노원구,CNG,사업용,0,100,0,0,100
2005,노원구,경유,비사업용,19626,5934,12815,31,38406
2005,노원구,경유,사업용,10,630,1736,9,2385
2005,노원구,기타연료,비사업용,7,1,4,1,13
2005,노원구,기타연료,사업용,0,0,5,0,5
2005,노원구,엘피지,비사업용,11407,4449,1453,0,17309
2005,노원구,엘피지,사업용,6517,0,309,0,6826
2005,노원구,휘발유,비사업용,15455,20,39,0,15514
2005,노원구,휘발유,사업용,10,0,0,0,10
2005,노원구,휘발유(무연),비사업용,70433,109,65,0,70607
2005,노원구,휘발유(무연),사업용,6,0,2,0,8
2005,노원구,휘발유(유연),비사업용,3,1,0,0,4
2005,은평구,CNG,비사업용,0,3,3,0,6
2005,은평구,CNG,사업용,0,378,0,0,378
2005,은평구,경유,비사업용,13127,5042,12213,35,30417
2005,은평구,경유,사업용,14,468,1769,57,2308
2005,은평구,기타연료,비사업용,3,0,2,2,7
2005,은평구,기타연료,사업용,0,0,1,1,2
2005,은평구,엘피지,비사업용,7215,3402,1289,0,11906
2005,은평구,엘피지,사업용,3717,0,216,2,3935
2005,은평구,휘발유,비사업용,12505,30,40,0,12575
2005,은평구,휘발유,사업용,4,0,0,0,4
2005,은평구,휘발유(무연),비사업용,46243,107,78,0,46428
2005,은평구,휘발유(무연),사업용,9,0,3,0,12
2005,은평구,휘발유(유연),비사업용,2,0,0,0,2
2005,서대문구,CNG,비사업용,0,2,0,0,2
2005,서대문구,CNG,사업용,0,103,0,0,103
2005,서대문구,경유,비사업용,10318,3470,8121,15,21924
2005,서대문구,경유,사업용,4,274,1790,37,2105
2005,서대문구,기타연료,비사업용,5,0,1,0,6
2005,서대문구,기타연료,사업용,0,10,14,0,24
2005,서대문구,알코올,사업용,1,0,0,0,1
2005,서대문구,엘피지,비사업용,4966,2300,894,0,8160
2005,서대문구,엘피지,사업용,2705,0,179,0,2884
2005,서대문구,휘발유,비사업용,9160,19,32,0,9211
2005,서대문구,휘발유,사업용,3,0,0,0,3
2005,서대문구,휘발유(무연),비사업용,37399,75,65,0,37539
2005,서대문구,휘발유(무연),사업용,4,0,1,0,5
2005,서대문구,휘발유(유연),비사업용,1,0,0,0,1
2005,마포구,CNG,비사업용,0,1,0,0,1
2005,마포구,CNG,사업용,0,71,0,0,71
2005,마포구,경유,비사업용,13421,4265,11434,55,29175
2005,마포구,경유,사업용,562,374,2580,55,3571
2005,마포구,기타연료,비사업용,7,0,4,1,12
2005,마포구,기타연료,사업용,0,0,47,0,47
2005,마포구,엘피지,비사업용,5808,3025,1245,1,10079
2005,마포구,엘피지,사업용,2885,5,179,0,3069
2005,마포구,휘발유,비사업용,12430,25,54,0,12509
2005,마포구,휘발유,사업용,444,0,0,0,444
2005,마포구,휘발유(무연),비사업용,47265,95,92,0,47452
2005,마포구,휘발유(무연),사업용,564,0,2,0,566
2005,마포구,휘발유(유연),비사업용,1,0,0,0,1
2005,양천구,CNG,사업용,0,95,0,0,95
2005,양천구,경유,비사업용,17064,5355,14453,47,36919
2005,양천구,경유,사업용,29,488,2486,262,3265
2005,양천구,기타연료,비사업용,2,1,9,2,14
2005,양천구,기타연료,사업용,0,0,129,0,129
2005,양천구,엘피지,비사업용,8489,3889,1298,0,13676
2005,양천구,엘피지,사업용,4665,4,226,0,4895
2005,양천구,휘발유,비사업용,15343,28,34,0,15405
2005,양천구,휘발유,사업용,19,0,1,0,20
2005,양천구,휘발유(무연),비사업용,65027,105,88,1,65221
2005,양천구,휘발유(무연),사업용,22,0,4,0,26
2005,양천구,휘발유(유연),비사업용,2,0,0,0,2
2005,강서구,CNG,비사업용,0,0,2,0,2
2005,강서구,CNG,사업용,0,108,0,0,108
2005,강서구,경유,비사업용,18855,6133,17573,81,42642
2005,강서구,경유,사업용,361,930,2380,35,3706
2005,강서구,기타연료,비사업용,12,2,29,1,44
2005,강서구,기타연료,사업용,0,0,25,0,25
2005,강서구,엘피지,비사업용,11053,4683,1932,0,17668
2005,강서구,엘피지,사업용,6722,3,262,0,6987
2005,강서구,휘발유,비사업용,16462,25,38,0,16525
2005,강서구,휘발유,사업용,1055,1,1,0,1057
2005,강서구,휘발유(무연),비사업용,68220,118,97,0,68435
2005,강서구,휘발유(무연),사업용,854,2,0,0,856
2005,구로구,CNG,비사업용,0,0,2,0,2
2005,구로구,CNG,사업용,0,32,0,0,32
2005,구로구,경유,비사업용,15771,5039,15751,26,36587
2005,구로구,경유,사업용,1221,689,1512,14,3436
2005,구로구,기타연료,비사업용,3,0,6,1,10
2005,구로구,기타연료,사업용,0,0,7,0,7
2005,구로구,알코올,비사업용,0,1,0,0,1
2005,구로구,엘피지,비사업용,7590,3320,1200,0,12110
2005,구로구,엘피지,사업용,5038,2,230,0,5270
2005,구로구,휘발유,비사업용,11728,15,38,0,11781
2005,구로구,휘발유,사업용,2227,0,0,0,2227
2005,구로구,휘발유(무연),비사업용,47992,72,81,0,48145
2005,구로구,휘발유(무연),사업용,1783,0,1,0,1784
2005,구로구,휘발유(유연),비사업용,2,0,0,0,2
2005,금천구,CNG,비사업용,0,0,1,0,1
2005,금천구,CNG,사업용,0,25,0,0,25
2005,금천구,경유,비사업용,9246,3524,10940,21,23731
2005,금천구,경유,사업용,16,392,2006,57,2471
2005,금천구,기타연료,비사업용,3,0,4,0,7
2005,금천구,등유,비사업용,0,1,0,0,1
2005,금천구,엘피지,비사업용,4485,2056,890,0,7431
2005,금천구,엘피지,사업용,2458,0,236,8,2702
2005,금천구,휘발유,비사업용,7601,10,37,0,7648
2005,금천구,휘발유,사업용,53,0,0,0,53
2005,금천구,휘발유(무연),비사업용,26983,43,74,0,27100
2005,금천구,휘발유(무연),사업용,7,0,0,0,7
2005,영등포구,CNG,비사업용,0,1,4,0,5
2005,영등포구,경유,비사업용,16683,5055,18051,105,39894
2005,영등포구,경유,사업용,175,331,3220,314,4040
2005,영등포구,기타연료,비사업용,12,1,13,4,30
2005,영등포구,기타연료,사업용,1,0,38,3,42
2005,영등포구,알코올,사업용,0,0,0,1,1
2005,영등포구,엘피지,비사업용,6949,3277,1333,1,11560
2005,영등포구,엘피지,사업용,3578,3,248,12,3841
2005,영등포구,휘발유,비사업용,17473,35,67,0,17575
2005,영등포구,휘발유,사업용,188,0,0,0,188
2005,영등포구,휘발유(무연),비사업용,56012,100,112,2,56226
2005,영등포구,휘발유(무연),사업용,123,0,2,0,125
2005,영등포구,휘발유(유연),비사업용,2,0,0,0,2
2005,동작구,CNG,비사업용,0,0,6,0,6
2005,동작구,경유,비사업용,11956,3577,8972,27,24532
2005,동작구,경유,사업용,2,99,1147,15,1263
2005,동작구,기타연료,비사업용,6,1,4,2,13
2005,동작구,기타연료,사업용,0,0,7,0,7
2005,동작구,엘피지,비사업용,6580,2643,991,1,10215
2005,동작구,엘피지,사업용,1426,0,121,0,1547
2005,동작구,휘발유,비사업용,11035,15,23,0,11073
2005,동작구,휘발유(무연),비사업용,45854,70,48,0,45972
2005,동작구,휘발유(무연),사업용,0,0,1,0,1
2005,동작구,휘발유(유연),비사업용,1,0,0,0,1
2005,관악구,CNG,비사업용,0,0,2,0,2
2005,관악구,경유,비사업용,14913,5167,12319,28,32427
2005,관악구,경유,사업용,228,510,1804,29,2571
2005,관악구,기타연료,비사업용,4,1,19,1,25
2005,관악구,기타연료,사업용,0,2,2,0,4
2005,관악구,엘피지,비사업용,7910,3335,1358,0,12603
2005,관악구,엘피지,사업용,2689,0,259,0,2948
2005,관악구,휘발유,비사업용,12696,22,48,1,12767
2005,관악구,휘발유,사업용,107,0,1,0,108
2005,관악구,휘발유(무연),비사업용,52193,88,72,0,52353
2005,관악구,휘발유(무연),사업용,64,0,2,0,66
2005,관악구,휘발유(유연),비사업용,1,0,0,0,1
2005,서초구,CNG,사업용,0,67,0,0,67
2005,서초구,경유,비사업용,17211,4249,14212,77,35749
2005,서초구,경유,사업용,358,549,4724,158,5789
2005,서초구,기타연료,비사업용,30,4,18,3,55
2005,서초구,기타연료,사업용,0,41,135,5,181
2005,서초구,등유,비사업용,1,1,0,0,2
2005,서초구,알코올,사업용,1,0,0,0,1
2005,서초구,엘피지,비사업용,5845,3224,1232,0,10301
2005,서초구,엘피지,사업용,2156,13,172,0,2341
2005,서초구,휘발유,비사업용,23751,47,75,0,23873
2005,서초구,휘발유,사업용,570,0,0,0,570
2005,서초구,휘발유(무연),비사업용,81514,211,94,0,81819
2005,서초구,휘발유(무연),사업용,314,0,0,0,314
2005,서초구,휘발유(유연),비사업용,6,0,0,0,6
2005,강남구,CNG,비사업용,3,3,1,0,7
2005,강남구,CNG,사업용,0,4,0,0,4
2005,강남구,경유,비사업용,23669,5588,17508,71,46836
2005,강남구,경유,사업용,583,567,1503,119,2772
2005,강남구,기타연료,비사업용,27,2,97,38,164
2005,강남구,기타연료,사업용,0,0,63,2,65
2005,강남구,알코올,사업용,1,0,0,0,1
2005,강남구,엘피지,비사업용,8268,4734,1885,0,14887
2005,강남구,엘피지,사업용,4318,3,86,0,4407
2005,강남구,휘발유,비사업용,39439,59,135,0,39633
2005,강남구,휘발유,사업용,1725,0,0,0,1725
2005,강남구,휘발유(무연),비사업용,117445,301,177,1,117924
2005,강남구,휘발유(무연),사업용,994,1,0,0,995
2005,강남구,휘발유(유연),비사업용,4,0,0,0,4
2005,송파구,CNG,비사업용,0,0,1,0,1
2005,송파구,CNG,사업용,0,275,0,0,275
2005,송파구,경유,비사업용,22908,6375,21333,44,50660
2005,송파구,경유,사업용,170,974,2917,85,4146
2005,송파구,기타연료,비사업용,12,1,12,1,26
2005,송파구,기타연료,사업용,0,0,54,0,54
2005,송파구,알코올,비사업용,0,0,1,0,1
2005,송파구,알코올,사업용,0,0,1,0,1
2005,송파구,엘피지,비사업용,10410,4892,2097,0,17399
2005,송파구,엘피지,사업용,4979,2,271,1,5253
2005,송파구,휘발유,비사업용,22168,23,83,0,22274
2005,송파구,휘발유,사업용,185,1,1,0,187
2005,송파구,휘발유(무연),비사업용,86943,142,106,0,87191
2005,송파구,휘발유(무연),사업용,200,1,2,0,203
2005,송파구,휘발유(유연),비사업용,3,0,0,0,3
2005,강동구,CNG,비사업용,0,0,1,0,1
2005,강동구,CNG,사업용,0,25,0,0,25
2005,강동구,경유,비사업용,16085,4882,14940,27,35934
2005,강동구,경유,사업용,80,412,1754,67,2313
2005,강동구,기타연료,비사업용,9,0,5,1,15
2005,강동구,기타연료,사업용,0,33,11,0,44
2005,강동구,엘피지,비사업용,8954,3575,1651,0,14180
2005,강동구,엘피지,사업용,5162,6,310,3,5481
2005,강동구,휘발유,비사업용,13837,29,55,0,13921
2005,강동구,휘발유,사업용,264,3,0,0,267
2005,강동구,휘발유(무연),비사업용,54730,84,96,0,54910
2005,강동구,휘발유(무연),사업용,135,0,2,0,137
2005,강동구,휘발유(유연),비사업용,1,0,0,0,1
2006,합계,계,계,2266106,198696,388988,3067,2856857
2006,종로구,CNG,비사업용,0,3,2,0,5
2006,종로구,CNG,사업용,0,82,0,0,82
2006,종로구,경유,비사업용,7527,3267,5952,52,16798
2006,종로구,경유,사업용,1816,858,358,41,3073
2006,종로구,기타연료,비사업용,5,7,4,2,18
2006,종로구,기타연료,사업용,0,0,79,0,79
2006,종로구,엘피지,비사업용,2420,1179,626,0,4225
2006,종로구,엘피지,사업용,3762,6,61,0,3829
2006,종로구,휘발유,비사업용,11302,28,48,0,11378
2006,종로구,휘발유,사업용,7029,6,0,0,7035
2006,종로구,휘발유(무연),비사업용,20919,78,45,0,21042
2006,종로구,휘발유(무연),사업용,1263,0,1,0,1264
2006,종로구,휘발유(유연),비사업용,1,0,0,0,1
2006,중구,CNG,비사업용,0,5,1,0,6
2006,중구,CNG,사업용,0,7,0,0,7
2006,중구,경유,비사업용,6789,2552,5845,87,15273
2006,중구,경유,사업용,304,203,1054,68,1629
2006,중구,기타연료,비사업용,5,1,17,5,28
2006,중구,기타연료,사업용,0,0,143,0,143
2006,중구,엘피지,비사업용,2183,1118,628,2,3931
2006,중구,엘피지,사업용,528,1,97,0,626
2006,중구,휘발유,비사업용,10638,23,26,0,10687
2006,중구,휘발유,사업용,675,3,0,0,678
2006,중구,휘발유(무연),비사업용,17660,68,46,0,17774
2006,중구,휘발유(무연),사업용,142,0,0,0,142
2006,중구,휘발유(유연),비사업용,2,0,0,0,2
2006,용산구,CNG,비사업용,0,2,6,0,8
2006,용산구,CNG,사업용,0,9,0,0,9
2006,용산구,경유,비사업용,8615,2627,6757,24,18023
2006,용산구,경유,사업용,31,131,972,43,1177
2006,용산구,기타연료,비사업용,1513,3,48,1,1565
2006,용산구,기타연료,사업용,0,0,25,1,26
2006,용산구,엘피지,비사업용,3376,1621,734,0,5731
2006,용산구,엘피지,사업용,906,1,100,0,1007
2006,용산구,휘발유,비사업용,13380,26,59,0,13465
2006,용산구,휘발유,사업용,109,0,0,0,109
2006,용산구,휘발유(무연),비사업용,30132,108,73,0,30313
2006,용산구,휘발유(무연),사업용,84,0,1,0,85
2006,용산구,휘발유(유연),비사업용,5,0,0,0,5
2006,성동구,CNG,비사업용,2,1,0,0,3
2006,성동구,CNG,사업용,0,52,0,0,52
2006,성동구,경유,비사업용,12354,3365,10838,46,26603
2006,성동구,경유,사업용,37,251,1543,65,1896
2006,성동구,기타연료,비사업용,8,3,7,1,19
2006,성동구,기타연료,사업용,0,0,16,0,16
2006,성동구,엘피지,비사업용,5811,2249,1249,0,9309
2006,성동구,엘피지,사업용,2377,0,360,1,2738
2006,성동구,휘발유,비사업용,12273,11,31,2,12317
2006,성동구,휘발유,사업용,149,0,0,0,149
2006,성동구,휘발유(무연),비사업용,35468,69,52,1,35590
2006,성동구,휘발유(무연),사업용,49,0,0,0,49
2006,광진구,CNG,비사업용,0,1,0,0,1
2006,광진구,경유,비사업용,12731,3754,10118,29,26632
2006,광진구,경유,사업용,24,328,1103,15,1470
2006,광진구,기타연료,비사업용,6,0,1,1,8
2006,광진구,엘피지,비사업용,6024,2513,1282,0,9819
2006,광진구,엘피지,사업용,2157,0,231,0,2388
2006,광진구,전기,비사업용,0,1,0,0,1
2006,광진구,휘발유,비사업용,12306,11,33,0,12350
2006,광진구,휘발유,사업용,6,0,0,0,6
2006,광진구,휘발유(무연),비사업용,37462,68,52,0,37582
2006,광진구,휘발유(무연),사업용,8,0,2,0,10
2006,광진구,휘발유(유연),비사업용,1,0,0,0,1
2006,동대문구,CNG,비사업용,0,1,6,0,7
2006,동대문구,경유,비사업용,12858,3993,11476,34,28361
2006,동대문구,경유,사업용,11,165,2061,27,2264
2006,동대문구,기타연료,비사업용,3,1,4,2,10
2006,동대문구,기타연료,사업용,0,0,7,0,7
2006,동대문구,엘피지,비사업용,6267,2553,1419,0,10239
2006,동대문구,엘피지,사업용,2607,0,382,1,2990
2006,동대문구,휘발유,비사업용,11430,12,37,0,11479
2006,동대문구,휘발유,사업용,53,0,0,0,53
2006,동대문구,휘발유(무연),비사업용,33456,62,55,0,33573
2006,동대문구,휘발유(무연),사업용,16,0,0,0,16
2006,동대문구,휘발유(유연),비사업용,2,0,0,0,2
2006,중랑구,CNG,비사업용,0,0,4,0,4
2006,중랑구,CNG,사업용,0,422,0,0,422
2006,중랑구,경유,비사업용,13364,4619,12599,33,30615
2006,중랑구,경유,사업용,44,529,2124,96,2793
2006,중랑구,기타연료,비사업용,3,2,4,1,10
2006,중랑구,기타연료,사업용,0,5,6,0,11
2006,중랑구,엘피지,비사업용,7662,2998,1765,0,12425
2006,중랑구,엘피지,사업용,5388,0,447,4,5839
2006,중랑구,전기,비사업용,0,1,0,0,1
2006,중랑구,휘발유,비사업용,11395,24,35,0,11454
2006,중랑구,휘발유,사업용,31,0,0,0,31
2006,중랑구,휘발유(무연),비사업용,36243,83,55,0,36381
2006,중랑구,휘발유(무연),사업용,6,0,2,0,8
2006,중랑구,휘발유(유연),비사업용,1,0,0,0,1
2006,성북구,CNG,비사업용,0,1,0,0,1
2006,성북구,CNG,사업용,0,342,0,0,342
2006,성북구,경유,비사업용,15602,4527,10242,30,30401
2006,성북구,경유,사업용,35,549,1435,3,2022
2006,성북구,기타연료,비사업용,5,0,11,1,17
2006,성북구,기타연료,사업용,0,19,0,0,19
2006,성북구,엘피지,비사업용,8060,3048,1476,2,12586
2006,성북구,엘피지,사업용,2795,0,359,0,3154
2006,성북구,휘발유,비사업용,13908,18,32,0,13958
2006,성북구,휘발유,사업용,7,0,0,0,7
2006,성북구,휘발유(무연),비사업용,44008,97,51,0,44156
2006,성북구,휘발유(무연),사업용,14,0,3,0,17
2006,성북구,휘발유(유연),비사업용,4,0,0,0,4
2006,강북구,CNG,비사업용,0,1,2,0,3
2006,강북구,CNG,사업용,0,221,0,0,221
2006,강북구,경유,비사업용,9667,3464,8135,18,21284
2006,강북구,경유,사업용,41,550,1168,5,1764
2006,강북구,기타연료,비사업용,0,0,3,0,3
2006,강북구,기타연료,사업용,0,4,1,0,5
2006,강북구,엘피지,비사업용,5948,2300,1320,0,9568
2006,강북구,엘피지,사업용,2834,2,345,0,3181
2006,강북구,휘발유,비사업용,8413,18,28,0,8459
2006,강북구,휘발유,사업용,11,0,1,0,12
2006,강북구,휘발유(무연),비사업용,27385,57,43,0,27485
2006,강북구,휘발유(무연),사업용,2,0,2,0,4
2006,강북구,휘발유(유연),비사업용,3,0,0,0,3
2006,도봉구,CNG,비사업용,0,1,0,0,1
2006,도봉구,CNG,사업용,0,302,0,0,302
2006,도봉구,경유,비사업용,12529,3647,9093,16,25285
2006,도봉구,경유,사업용,26,278,1094,27,1425
2006,도봉구,기타연료,비사업용,2,1,7,1,11
2006,도봉구,기타연료,사업용,0,0,3,0,3
2006,도봉구,엘피지,비사업용,7024,2723,1320,0,11067
2006,도봉구,엘피지,사업용,5560,2,255,0,5817
2006,도봉구,휘발유,비사업용,10623,12,21,0,10656
2006,도봉구,휘발유,사업용,14,0,0,0,14
2006,도봉구,휘발유(무연),비사업용,38326,71,46,0,38443
2006,도봉구,휘발유(무연),사업용,9,0,2,0,11
2006,도봉구,휘발유(유연),비사업용,2,0,0,0,2
2006,노원구,CNG,비사업용,4,2,0,0,6
2006,노원구,CNG,사업용,0,222,0,0,222
2006,노원구,경유,비사업용,21344,5807,12415,29,39595
2006,노원구,경유,사업용,21,510,1664,13,2208
2006,노원구,기타연료,비사업용,6,3,5,1,15
2006,노원구,기타연료,사업용,0,0,6,0,6
2006,노원구,엘피지,비사업용,12491,4276,1838,0,18605
2006,노원구,엘피지,사업용,6381,0,373,0,6754
2006,노원구,휘발유,비사업용,18055,14,34,0,18103
2006,노원구,휘발유,사업용,15,0,0,0,15
2006,노원구,휘발유(무연),비사업용,65976,113,60,0,66149
2006,노원구,휘발유(무연),사업용,4,0,3,0,7
2006,노원구,휘발유(유연),비사업용,2,0,0,0,2
2006,은평구,CNG,비사업용,0,3,6,0,9
2006,은평구,CNG,사업용,0,436,0,0,436
2006,은평구,경유,비사업용,14095,4834,11694,31,30654
2006,은평구,경유,사업용,12,399,1652,59,2122
2006,은평구,기타연료,비사업용,2,1,1,2,6
2006,은평구,기타연료,사업용,0,0,2,1,3
2006,은평구,알코올,비사업용,0,0,1,0,1
2006,은평구,엘피지,비사업용,7816,3274,1581,0,12671
2006,은평구,엘피지,사업용,3679,0,290,2,3971
2006,은평구,휘발유,비사업용,14157,26,32,0,14215
2006,은평구,휘발유,사업용,6,0,0,0,6
2006,은평구,휘발유(무연),비사업용,43057,97,71,0,43225
2006,은평구,휘발유(무연),사업용,5,0,1,0,6
2006,은평구,휘발유(유연),비사업용,2,0,0,0,2
2006,서대문구,CNG,비사업용,0,2,0,0,2
2006,서대문구,CNG,사업용,0,152,0,0,152
2006,서대문구,경유,비사업용,11217,3345,7876,22,22460
2006,서대문구,경유,사업용,2,248,1790,46,2086
2006,서대문구,기타연료,비사업용,8,0,5,0,13
2006,서대문구,기타연료,사업용,0,10,11,0,21
2006,서대문구,알코올,사업용,1,0,0,0,1
2006,서대문구,엘피지,비사업용,5551,2266,1063,0,8880
2006,서대문구,엘피지,사업용,2570,0,218,0,2788
2006,서대문구,휘발유,비사업용,11142,16,32,0,11190
2006,서대문구,휘발유,사업용,3,0,0,0,3
2006,서대문구,휘발유(무연),비사업용,34850,63,46,0,34959
2006,서대문구,휘발유(무연),사업용,1,0,1,0,2
2006,서대문구,휘발유(유연),비사업용,1,0,0,0,1
2006,마포구,CNG,비사업용,0,1,0,0,1
2006,마포구,CNG,사업용,0,95,0,0,95
2006,마포구,경유,비사업용,14808,4118,11225,57,30208
2006,마포구,경유,사업용,636,379,2379,77,3471
2006,마포구,기타연료,비사업용,3,0,16,1,20
2006,마포구,기타연료,사업용,0,0,48,0,48
2006,마포구,엘피지,비사업용,6521,2866,1437,1,10825
2006,마포구,엘피지,사업용,3167,1,194,0,3362
2006,마포구,휘발유,비사업용,15539,24,51,0,15614
2006,마포구,휘발유,사업용,729,0,0,0,729
2006,마포구,휘발유(무연),비사업용,44498,86,74,0,44658
2006,마포구,휘발유(무연),사업용,298,0,1,0,299
2006,마포구,휘발유(유연),비사업용,2,0,0,0,2
2006,양천구,CNG,사업용,0,197,0,0,197
2006,양천구,경유,비사업용,18542,5226,13908,70,37746
2006,양천구,경유,사업용,34,496,2502,310,3342
2006,양천구,기타연료,비사업용,4,2,11,2,19
2006,양천구,기타연료,사업용,0,0,160,0,160
2006,양천구,엘피지,비사업용,9305,3722,1782,0,14809
2006,양천구,엘피지,사업용,4726,4,289,0,5019
2006,양천구,휘발유,비사업용,19010,25,31,0,19066
2006,양천구,휘발유,사업용,31,0,0,0,31
2006,양천구,휘발유(무연),비사업용,61573,94,75,1,61743
2006,양천구,휘발유(무연),사업용,12,0,3,0,15
2006,양천구,휘발유(유연),비사업용,1,0,0,0,1
2006,강서구,CNG,비사업용,0,0,2,0,2
2006,강서구,CNG,사업용,0,140,0,0,140
2006,강서구,경유,비사업용,20749,6070,17230,76,44125
2006,강서구,경유,사업용,600,913,2277,50,3840
2006,강서구,기타연료,비사업용,14,2,39,2,57
2006,강서구,기타연료,사업용,0,0,12,0,12
2006,강서구,엘피지,비사업용,12433,4519,2428,0,19380
2006,강서구,엘피지,사업용,7035,1,334,0,7370
2006,강서구,휘발유,비사업용,19862,21,35,0,19918
2006,강서구,휘발유,사업용,1774,1,0,0,1775
2006,강서구,휘발유(무연),비사업용,65099,111,87,0,65297
2006,강서구,휘발유(무연),사업용,592,2,0,0,594
2006,강서구,휘발유(유연),비사업용,1,1,0,0,2
2006,구로구,CNG,비사업용,0,0,3,0,3
2006,구로구,CNG,사업용,0,38,0,0,38
2006,구로구,경유,비사업용,17435,4977,15441,25,37878
2006,구로구,경유,사업용,1944,746,1583,17,4290
2006,구로구,기타연료,비사업용,2,0,6,1,9
2006,구로구,기타연료,사업용,0,1,10,0,11
2006,구로구,엘피지,비사업용,8477,3257,1575,2,13311
2006,구로구,엘피지,사업용,6187,3,312,0,6502
2006,구로구,휘발유,비사업용,14429,11,35,0,14475
2006,구로구,휘발유,사업용,4370,0,0,0,4370
2006,구로구,휘발유(무연),비사업용,45865,73,55,0,45993
2006,구로구,휘발유(무연),사업용,1081,0,2,0,1083
2006,구로구,휘발유(유연),비사업용,3,0,0,0,3
2006,금천구,CNG,비사업용,0,0,1,0,1
2006,금천구,CNG,사업용,0,92,0,0,92
2006,금천구,경유,비사업용,10041,3477,10660,27,24205
2006,금천구,경유,사업용,22,324,2314,65,2725
2006,금천구,기타연료,비사업용,2,0,5,0,7
2006,금천구,기타연료,사업용,0,0,12,0,12
2006,금천구,등유,비사업용,0,1,0,0,1
2006,금천구,엘피지,비사업용,4900,1986,1133,0,8019
2006,금천구,엘피지,사업용,2464,0,273,4,2741
2006,금천구,휘발유,비사업용,8794,12,38,0,8844
2006,금천구,휘발유,사업용,38,0,0,0,38
2006,금천구,휘발유(무연),비사업용,25000,42,56,0,25098
2006,금천구,휘발유(무연),사업용,1,0,0,0,1
2006,영등포구,CNG,비사업용,0,1,4,0,5
2006,영등포구,CNG,사업용,0,6,0,0,6
2006,영등포구,경유,비사업용,18991,5127,17563,109,41790
2006,영등포구,경유,사업용,196,394,3239,321,4150
2006,영등포구,기타연료,비사업용,10,1,14,3,28
2006,영등포구,기타연료,사업용,1,0,88,3,92
2006,영등포구,알코올,사업용,0,0,0,1,1
2006,영등포구,엘피지,비사업용,7747,3080,1580,1,12408
2006,영등포구,엘피지,사업용,3941,2,326,7,4276
2006,영등포구,휘발유,비사업용,21900,35,67,0,22002
2006,영등포구,휘발유,사업용,315,1,0,0,316
2006,영등포구,휘발유(무연),비사업용,51712,92,90,1,51895
2006,영등포구,휘발유(무연),사업용,63,0,1,0,64
2006,영등포구,휘발유(유연),비사업용,2,0,0,0,2
2006,동작구,CNG,비사업용,0,0,7,0,7
2006,동작구,CNG,사업용,0,3,0,0,3
2006,동작구,경유,비사업용,13071,3483,8620,26,25200
2006,동작구,경유,사업용,3,127,1086,16,1232
2006,동작구,기타연료,비사업용,4,1,5,2,12
2006,동작구,기타연료,사업용,0,0,6,0,6
2006,동작구,엘피지,비사업용,7189,2480,1170,0,10839
2006,동작구,엘피지,사업용,1429,0,176,0,1605
2006,동작구,휘발유,비사업용,13493,18,23,0,13534
2006,동작구,휘발유,사업용,1,0,0,0,1
2006,동작구,휘발유(무연),비사업용,42627,66,38,0,42731
2006,동작구,휘발유(무연),사업용,0,0,1,0,1
2006,동작구,휘발유(유연),비사업용,2,0,0,0,2
2006,관악구,CNG,비사업용,0,0,3,0,3
2006,관악구,CNG,사업용,0,28,0,0,28
2006,관악구,경유,비사업용,16594,4987,11809,30,33420
2006,관악구,경유,사업용,213,488,1710,43,2454
2006,관악구,기타연료,비사업용,3,1,20,1,25
2006,관악구,기타연료,사업용,0,1,3,0,4
2006,관악구,알코올,비사업용,0,0,1,0,1
2006,관악구,엘피지,비사업용,8945,3280,1723,3,13951
2006,관악구,엘피지,사업용,2887,0,316,0,3203
2006,관악구,휘발유,비사업용,15217,20,41,1,15279
2006,관악구,휘발유,사업용,161,0,0,0,161
2006,관악구,휘발유(무연),비사업용,50028,83,59,0,50170
2006,관악구,휘발유(무연),사업용,18,0,2,0,20
2006,관악구,휘발유(유연),비사업용,1,0,0,0,1
2006,서초구,CNG,비사업용,0,0,1,0,1
2006,서초구,CNG,사업용,0,80,0,0,80
2006,서초구,경유,비사업용,18941,4275,14172,83,37471
2006,서초구,경유,사업용,423,528,4578,158,5687
2006,서초구,기타연료,비사업용,17,4,32,3,56
2006,서초구,기타연료,사업용,0,41,140,4,185
2006,서초구,등유,비사업용,1,1,0,0,2
2006,서초구,알코올,비사업용,0,0,1,0,1
2006,서초구,엘피지,비사업용,6238,3460,1327,1,11026
2006,서초구,엘피지,사업용,2236,12,180,0,2428
2006,서초구,휘발유,비사업용,33007,58,66,0,33131
2006,서초구,휘발유,사업용,672,1,0,0,673
2006,서초구,휘발유(무연),비사업용,74462,178,83,0,74723
2006,서초구,휘발유(무연),사업용,163,0,0,0,163
2006,서초구,휘발유(유연),비사업용,6,0,0,0,6
2006,강남구,CNG,비사업용,3,3,1,0,7
2006,강남구,CNG,사업용,0,24,0,0,24
2006,강남구,경유,비사업용,26491,5555,17017,51,49114
2006,강남구,경유,사업용,789,579,1401,83,2852
2006,강남구,기타연료,비사업용,32,4,49,32,117
2006,강남구,기타연료,사업용,0,0,28,2,30
2006,강남구,알코올,비사업용,0,0,1,0,1
2006,강남구,알코올,사업용,2,0,0,0,2
2006,강남구,엘피지,비사업용,8915,4302,2025,2,15244
2006,강남구,엘피지,사업용,4930,2,116,0,5048
2006,강남구,휘발유,비사업용,53872,72,141,0,54085
2006,강남구,휘발유,사업용,2255,0,0,0,2255
2006,강남구,휘발유(무연),비사업용,107439,267,150,1,107857
2006,강남구,휘발유(무연),사업용,639,1,0,0,640
2006,강남구,휘발유(유연),비사업용,2,0,0,0,2
2006,송파구,CNG,비사업용,0,0,1,0,1
2006,송파구,CNG,사업용,0,342,0,0,342
2006,송파구,경유,비사업용,24921,6196,20433,76,51626
2006,송파구,경유,사업용,186,931,2958,90,4165
2006,송파구,기타연료,비사업용,5,1,63,14,83
2006,송파구,기타연료,사업용,0,0,55,0,55
2006,송파구,알코올,비사업용,0,0,2,0,2
2006,송파구,엘피지,비사업용,11206,4611,2484,1,18302
2006,송파구,엘피지,사업용,4949,2,333,0,5284
2006,송파구,휘발유,비사업용,28004,23,74,0,28101
2006,송파구,휘발유,사업용,290,1,1,0,292
2006,송파구,휘발유(무연),비사업용,80308,125,94,0,80527
2006,송파구,휘발유(무연),사업용,109,1,1,0,111
2006,송파구,휘발유(유연),비사업용,3,0,0,0,3
2006,강동구,CNG,비사업용,0,0,1,0,1
2006,강동구,CNG,사업용,0,81,0,0,81
2006,강동구,경유,비사업용,17499,4719,14494,33,36745
2006,강동구,경유,사업용,100,384,1789,79,2352
2006,강동구,기타연료,비사업용,8,2,4,2,16
2006,강동구,기타연료,사업용,0,33,40,0,73
2006,강동구,등유,비사업용,0,1,0,0,1
2006,강동구,알코올,비사업용,0,0,1,0,1
2006,강동구,엘피지,비사업용,9661,3185,1743,0,14589
2006,강동구,엘피지,사업용,5363,3,364,2,5732
2006,강동구,휘발유,비사업용,16490,27,46,0,16563
2006,강동구,휘발유,사업용,423,3,0,0,426
2006,강동구,휘발유(무연),비사업용,50993,72,80,0,51145
2006,강동구,휘발유(무연),사업용,87,0,0,0,87
2006,강동구,휘발유(유연),비사업용,2,0,0,0,2
2007,합계,계,계,2347758,195302,386876,3350,2933286
2007,종로구,CNG,비사업용,0,3,6,0,9
2007,종로구,CNG,사업용,1,83,0,0,84
2007,종로구,경유,비사업용,8226,3223,6116,62,17627
2007,종로구,경유,사업용,3438,827,270,20,4555
2007,종로구,기타연료,비사업용,5,7,6,3,21
2007,종로구,기타연료,사업용,0,1,24,0,25
2007,종로구,엘피지,비사업용,2513,1120,686,0,4319
2007,종로구,엘피지,사업용,5132,6,73,0,5211
2007,종로구,휘발유,비사업용,17804,26,44,0,17874
2007,종로구,휘발유,사업용,8764,6,0,0,8770
2007,종로구,휘발유(무연),비사업용,19352,70,39,0,19461
2007,종로구,휘발유(무연),사업용,1253,0,1,0,1254
2007,종로구,휘발유(유연),비사업용,1,0,0,0,1
2007,중구,CNG,비사업용,0,6,4,0,10
2007,중구,CNG,사업용,0,7,0,0,7
2007,중구,경유,비사업용,8589,2636,5667,44,16936
2007,중구,경유,사업용,434,212,1352,68,2066
2007,중구,기타연료,비사업용,6,1,14,5,26
2007,중구,기타연료,사업용,0,0,158,0,158
2007,중구,엘피지,비사업용,2275,1102,642,3,4022
2007,중구,엘피지,사업용,663,1,118,0,782
2007,중구,휘발유,비사업용,19269,25,23,0,19317
2007,중구,휘발유,사업용,1049,2,0,0,1051
2007,중구,휘발유(무연),비사업용,16944,59,39,0,17042
2007,중구,휘발유(무연),사업용,78,0,0,0,78
2007,중구,휘발유(유연),비사업용,2,0,0,0,2
2007,용산구,CNG,비사업용,0,2,7,0,9
2007,용산구,CNG,사업용,0,36,0,0,36
2007,용산구,경유,비사업용,9087,2548,6853,19,18507
2007,용산구,경유,사업용,38,124,1014,44,1220
2007,용산구,기타연료,비사업용,1627,3,45,1,1676
2007,용산구,기타연료,사업용,0,0,26,1,27
2007,용산구,엘피지,비사업용,3584,1527,821,0,5932
2007,용산구,엘피지,사업용,881,0,118,0,999
2007,용산구,휘발유,비사업용,15080,24,71,0,15175
2007,용산구,휘발유,사업용,108,0,0,0,108
2007,용산구,휘발유(무연),비사업용,28487,100,59,0,28646
2007,용산구,휘발유(무연),사업용,79,0,1,0,80
2007,용산구,휘발유(유연),비사업용,2,0,0,0,2
2007,성동구,CNG,비사업용,2,1,2,0,5
2007,성동구,CNG,사업용,0,80,0,0,80
2007,성동구,경유,비사업용,12897,3166,10328,46,26437
2007,성동구,경유,사업용,42,243,1540,102,1927
2007,성동구,기타연료,비사업용,6,3,8,1,18
2007,성동구,기타연료,사업용,0,0,14,0,14
2007,성동구,엘피지,비사업용,6110,2197,1520,1,9828
2007,성동구,엘피지,사업용,2368,0,358,1,2727
2007,성동구,전기,비사업용,1,0,0,0,1
2007,성동구,휘발유,비사업용,14629,9,29,2,14669
2007,성동구,휘발유,사업용,159,0,0,0,159
2007,성동구,휘발유(무연),비사업용,33643,68,40,1,33752
2007,성동구,휘발유(무연),사업용,48,0,1,0,49
2007,성동구,휘발유(유연),비사업용,1,0,0,0,1
2007,광진구,CNG,비사업용,1,1,5,0,7
2007,광진구,경유,비사업용,13449,3533,9691,24,26697
2007,광진구,경유,사업용,20,256,1140,19,1435
2007,광진구,기타연료,비사업용,6,2,7,1,16
2007,광진구,기타연료,사업용,0,0,2,0,2
2007,광진구,엘피지,비사업용,6406,2526,1522,0,10454
2007,광진구,엘피지,사업용,2148,0,245,0,2393
2007,광진구,전기,비사업용,0,1,0,0,1
2007,광진구,휘발유,비사업용,14420,11,29,0,14460
2007,광진구,휘발유,사업용,10,0,0,0,10
2007,광진구,휘발유(무연),비사업용,35560,64,53,0,35677
2007,광진구,휘발유(무연),사업용,5,0,1,0,6
2007,광진구,휘발유(유연),비사업용,1,0,0,0,1
2007,동대문구,CNG,비사업용,0,1,9,0,10
2007,동대문구,경유,비사업용,13588,3825,10964,37,28414
2007,동대문구,경유,사업용,14,186,1975,37,2212
2007,동대문구,기타연료,비사업용,3,1,8,2,14
2007,동대문구,기타연료,사업용,0,0,6,0,6
2007,동대문구,엘피지,비사업용,6640,2510,1731,0,10881
2007,동대문구,엘피지,사업용,2643,0,387,1,3031
2007,동대문구,휘발유,비사업용,12982,10,37,0,13029
2007,동대문구,휘발유,사업용,63,0,0,0,63
2007,동대문구,휘발유(무연),비사업용,31584,54,51,0,31689
2007,동대문구,휘발유(무연),사업용,15,0,0,0,15
2007,동대문구,휘발유(유연),비사업용,2,0,0,0,2
2007,중랑구,CNG,비사업용,0,0,8,0,8
2007,중랑구,CNG,사업용,0,493,0,0,493
2007,중랑구,경유,비사업용,14217,4433,12117,32,30799
2007,중랑구,경유,사업용,36,487,2117,106,2746
2007,중랑구,기타연료,비사업용,2,2,3,1,8
2007,중랑구,기타연료,사업용,0,5,3,0,8
2007,중랑구,엘피지,비사업용,8140,3186,2244,0,13570
2007,중랑구,엘피지,사업용,5526,1,501,5,6033
2007,중랑구,휘발유,비사업용,12678,20,35,0,12733
2007,중랑구,휘발유,사업용,31,0,0,0,31
2007,중랑구,휘발유(무연),비사업용,34701,70,47,0,34818
2007,중랑구,휘발유(무연),사업용,4,0,2,0,6
2007,중랑구,휘발유(유연),비사업용,1,0,0,0,1
2007,성북구,CNG,비사업용,0,1,3,0,4
2007,성북구,CNG,사업용,0,468,0,0,468
2007,성북구,경유,비사업용,16728,4355,9841,27,30951
2007,성북구,경유,사업용,43,449,1368,11,1871
2007,성북구,기타연료,비사업용,4,0,13,2,19
2007,성북구,기타연료,사업용,0,19,0,0,19
2007,성북구,엘피지,비사업용,8463,3111,1776,1,13351
2007,성북구,엘피지,사업용,2758,0,403,0,3161
2007,성북구,휘발유,비사업용,16336,15,38,0,16389
2007,성북구,휘발유,사업용,15,0,0,0,15
2007,성북구,휘발유(무연),비사업용,41816,90,44,0,41950
2007,성북구,휘발유(무연),사업용,3,0,2,0,5
2007,성북구,휘발유(유연),비사업용,2,0,0,0,2
2007,강북구,CNG,비사업용,0,1,7,0,8
2007,강북구,CNG,사업용,0,354,0,0,354
2007,강북구,경유,비사업용,10149,3301,7762,27,21239
2007,강북구,경유,사업용,11,383,1129,3,1526
2007,강북구,기타연료,비사업용,0,0,3,0,3
2007,강북구,기타연료,사업용,0,4,1,0,5
2007,강북구,엘피지,비사업용,6255,2390,1634,0,10279
2007,강북구,엘피지,사업용,2624,0,386,0,3010
2007,강북구,휘발유,비사업용,9076,12,25,0,9113
2007,강북구,휘발유,사업용,3,0,0,0,3
2007,강북구,휘발유(무연),비사업용,26048,47,34,0,26129
2007,강북구,휘발유(무연),사업용,2,0,1,0,3
2007,강북구,휘발유(유연),비사업용,3,0,0,0,3
2007,도봉구,CNG,비사업용,0,1,3,0,4
2007,도봉구,CNG,사업용,0,327,0,0,327
2007,도봉구,경유,비사업용,13258,3524,8805,16,25603
2007,도봉구,경유,사업용,28,254,1102,41,1425
2007,도봉구,기타연료,비사업용,2,1,9,1,13
2007,도봉구,기타연료,사업용,0,0,3,0,3
2007,도봉구,엘피지,비사업용,7427,2804,1659,0,11890
2007,도봉구,엘피지,사업용,5614,3,270,0,5887
2007,도봉구,휘발유,비사업용,12257,7,16,0,12280
2007,도봉구,휘발유,사업용,15,0,0,0,15
2007,도봉구,휘발유(무연),비사업용,36026,63,40,1,36130
2007,도봉구,휘발유(무연),사업용,4,0,1,0,5
2007,도봉구,휘발유(유연),비사업용,1,0,0,0,1
2007,노원구,CNG,비사업용,4,2,1,0,7
2007,노원구,CNG,사업용,0,416,0,0,416
2007,노원구,경유,비사업용,22667,5584,12030,29,40310
2007,노원구,경유,사업용,33,360,1602,36,2031
2007,노원구,기타연료,비사업용,4,2,9,2,17
2007,노원구,기타연료,사업용,0,0,6,0,6
2007,노원구,알코올,비사업용,0,1,0,0,1
2007,노원구,엘피지,비사업용,13253,4326,2158,1,19738
2007,노원구,엘피지,사업용,6687,2,408,0,7097
2007,노원구,휘발유,비사업용,20968,14,31,0,21013
2007,노원구,휘발유,사업용,20,0,0,0,20
2007,노원구,휘발유(무연),비사업용,62370,104,47,0,62521
2007,노원구,휘발유(무연),사업용,6,0,5,0,11
2007,노원구,휘발유(유연),비사업용,2,0,0,0,2
2007,은평구,CNG,비사업용,0,3,8,0,11
2007,은평구,CNG,사업용,0,494,0,0,494
2007,은평구,경유,비사업용,14925,4652,11313,27,30917
2007,은평구,경유,사업용,13,343,1380,70,1806
2007,은평구,기타연료,비사업용,2,1,1,1,5
2007,은평구,기타연료,사업용,0,0,2,1,3
2007,은평구,알코올,비사업용,0,0,1,0,1
2007,은평구,엘피지,비사업용,8234,3211,1816,0,13261
2007,은평구,엘피지,사업용,3691,0,295,1,3987
2007,은평구,휘발유,비사업용,15554,24,33,0,15611
2007,은평구,휘발유,사업용,25,0,0,0,25
2007,은평구,휘발유(무연),비사업용,40598,95,66,0,40759
2007,은평구,휘발유(무연),사업용,2,0,1,0,3
2007,은평구,휘발유(유연),비사업용,2,0,0,0,2
2007,서대문구,CNG,비사업용,0,2,3,0,5
2007,서대문구,CNG,사업용,0,185,0,0,185
2007,서대문구,경유,비사업용,11854,3245,7692,43,22834
2007,서대문구,경유,사업용,2,207,1718,74,2001
2007,서대문구,기타연료,비사업용,4,0,4,0,8
2007,서대문구,기타연료,사업용,0,10,10,0,20
2007,서대문구,알코올,사업용,1,0,0,0,1
2007,서대문구,엘피지,비사업용,5967,2225,1259,1,9452
2007,서대문구,엘피지,사업용,2456,0,247,0,2703
2007,서대문구,휘발유,비사업용,12766,15,32,0,12813
2007,서대문구,휘발유,사업용,3,0,1,0,4
2007,서대문구,휘발유(무연),비사업용,32924,59,41,0,33024
2007,서대문구,휘발유(무연),사업용,2,0,0,0,2
2007,서대문구,휘발유(유연),비사업용,2,0,0,0,2
2007,마포구,CNG,비사업용,0,2,7,0,9
2007,마포구,CNG,사업용,0,118,0,0,118
2007,마포구,경유,비사업용,15713,3923,10830,56,30522
2007,마포구,경유,사업용,676,404,2425,81,3586
2007,마포구,기타연료,비사업용,3,1,11,1,16
2007,마포구,기타연료,사업용,0,0,45,0,45
2007,마포구,엘피지,비사업용,6928,2826,1578,3,11335
2007,마포구,엘피지,사업용,3354,2,217,0,3573
2007,마포구,휘발유,비사업용,18077,23,49,0,18149
2007,마포구,휘발유,사업용,893,0,0,0,893
2007,마포구,휘발유(무연),비사업용,41935,73,69,0,42077
2007,마포구,휘발유(무연),사업용,97,0,0,0,97
2007,양천구,CNG,비사업용,1,0,3,0,4
2007,양천구,CNG,사업용,0,266,0,0,266
2007,양천구,경유,비사업용,19936,5028,13683,80,38727
2007,양천구,경유,사업용,33,581,2336,317,3267
2007,양천구,기타연료,비사업용,5,3,14,2,24
2007,양천구,기타연료,사업용,0,0,173,0,173
2007,양천구,엘피지,비사업용,9820,3705,2266,1,15792
2007,양천구,엘피지,사업용,4957,4,329,0,5290
2007,양천구,휘발유,비사업용,22320,22,30,0,22372
2007,양천구,휘발유,사업용,31,0,0,0,31
2007,양천구,휘발유(무연),비사업용,58635,83,66,1,58785
2007,양천구,휘발유(무연),사업용,10,0,2,0,12
2007,양천구,휘발유(유연),비사업용,1,0,0,0,1
2007,강서구,CNG,비사업용,1,0,8,0,9
2007,강서구,CNG,사업용,0,182,0,0,182
2007,강서구,경유,비사업용,22455,5822,16973,77,45327
2007,강서구,경유,사업용,690,866,2272,70,3898
2007,강서구,기타연료,비사업용,12,4,45,2,63
2007,강서구,기타연료,사업용,0,0,14,0,14
2007,강서구,엘피지,비사업용,13164,4561,2828,0,20553
2007,강서구,엘피지,사업용,7054,0,387,0,7441
2007,강서구,휘발유,비사업용,23212,21,32,0,23265
2007,강서구,휘발유,사업용,2552,1,0,0,2553
2007,강서구,휘발유(무연),비사업용,63184,98,74,0,63356
2007,강서구,휘발유(무연),사업용,231,2,0,0,233
2007,강서구,휘발유(유연),비사업용,1,1,0,0,2
2007,구로구,CNG,비사업용,0,0,6,0,6
2007,구로구,CNG,사업용,0,90,0,0,90
2007,구로구,경유,비사업용,18834,4910,15025,30,38799
2007,구로구,경유,사업용,2835,796,1636,73,5340
2007,구로구,기타연료,비사업용,2,1,9,1,13
2007,구로구,기타연료,사업용,0,0,9,0,9
2007,구로구,등유,사업용,1,0,0,0,1
2007,구로구,엘피지,비사업용,9060,3263,1997,4,14324
2007,구로구,엘피지,사업용,7513,6,332,3,7854
2007,구로구,휘발유,비사업용,16770,12,35,0,16817
2007,구로구,휘발유,사업용,5789,0,0,0,5789
2007,구로구,휘발유(무연),비사업용,43679,59,62,0,43800
2007,구로구,휘발유(무연),사업용,740,0,2,0,742
2007,구로구,휘발유(유연),비사업용,4,0,0,0,4
2007,금천구,CNG,비사업용,0,0,2,0,2
2007,금천구,CNG,사업용,0,123,0,0,123
2007,금천구,경유,비사업용,10514,3346,10289,35,24184
2007,금천구,경유,사업용,20,299,1950,17,2286
2007,금천구,기타연료,비사업용,2,0,6,0,8
2007,금천구,기타연료,사업용,0,0,15,0,15
2007,금천구,엘피지,비사업용,5118,1984,1467,3,8572
2007,금천구,엘피지,사업용,2448,0,284,0,2732
2007,금천구,휘발유,비사업용,9673,11,39,0,9723
2007,금천구,휘발유,사업용,22,0,0,0,22
2007,금천구,휘발유(무연),비사업용,23458,36,42,0,23536
2007,금천구,휘발유(무연),사업용,2,0,0,0,2
2007,영등포구,CNG,비사업용,0,2,11,0,13
2007,영등포구,CNG,사업용,2,28,0,0,30
2007,영등포구,경유,비사업용,22093,5300,17454,140,44987
2007,영등포구,경유,사업용,426,528,3290,354,4598
2007,영등포구,기타연료,비사업용,11,2,18,3,34
2007,영등포구,기타연료,사업용,1,0,108,3,112
2007,영등포구,알코올,사업용,0,0,0,1,1
2007,영등포구,엘피지,비사업용,8375,3012,1890,1,13278
2007,영등포구,엘피지,사업용,5805,7,357,2,6171
2007,영등포구,휘발유,비사업용,25653,38,68,1,25760
2007,영등포구,휘발유,사업용,566,1,0,0,567
2007,영등포구,휘발유(무연),비사업용,48094,89,84,1,48268
2007,영등포구,휘발유(무연),사업용,88,0,1,0,89
2007,영등포구,휘발유(유연),비사업용,2,0,0,0,2
2007,동작구,CNG,비사업용,0,0,10,0,10
2007,동작구,CNG,사업용,0,10,0,0,10
2007,동작구,경유,비사업용,13844,3377,8170,26,25417
2007,동작구,경유,사업용,4,139,1036,23,1202
2007,동작구,기타연료,비사업용,6,2,5,2,15
2007,동작구,기타연료,사업용,0,0,3,0,3
2007,동작구,엘피지,비사업용,7550,2461,1371,0,11382
2007,동작구,엘피지,사업용,1415,0,200,0,1615
2007,동작구,휘발유,비사업용,15672,16,19,0,15707
2007,동작구,휘발유,사업용,1,0,0,0,1
2007,동작구,휘발유(무연),비사업용,40027,58,30,0,40115
2007,동작구,휘발유(무연),사업용,0,0,1,0,1
2007,동작구,휘발유(유연),비사업용,3,0,0,0,3
2007,관악구,CNG,비사업용,0,0,4,0,4
2007,관악구,CNG,사업용,0,74,0,0,74
2007,관악구,경유,비사업용,17665,4816,11256,32,33769
2007,관악구,경유,사업용,210,362,1681,54,2307
2007,관악구,기타연료,비사업용,3,0,12,1,16
2007,관악구,기타연료,사업용,0,1,4,0,5
2007,관악구,등유,비사업용,1,0,0,0,1
2007,관악구,엘피지,비사업용,9435,3278,2051,1,14765
2007,관악구,엘피지,사업용,2996,2,341,1,3340
2007,관악구,휘발유,비사업용,17426,17,37,1,17481
2007,관악구,휘발유,사업용,172,0,0,0,172
2007,관악구,휘발유(무연),비사업용,47204,72,49,0,47325
2007,관악구,휘발유(무연),사업용,4,0,2,0,6
2007,관악구,휘발유(유연),비사업용,1,0,0,0,1
2007,서초구,CNG,비사업용,0,0,2,0,2
2007,서초구,CNG,사업용,0,137,0,0,137
2007,서초구,경유,비사업용,22040,4253,13741,93,40127
2007,서초구,경유,사업용,395,466,4405,143,5409
2007,서초구,기타연료,비사업용,16,4,39,3,62
2007,서초구,기타연료,사업용,0,41,114,4,159
2007,서초구,등유,비사업용,1,0,0,0,1
2007,서초구,알코올,비사업용,0,0,1,0,1
2007,서초구,엘피지,비사업용,6485,3213,1506,0,11204
2007,서초구,엘피지,사업용,2685,5,173,0,2863
2007,서초구,휘발유,비사업용,51325,58,71,0,51454
2007,서초구,휘발유,사업용,1055,1,0,0,1056
2007,서초구,휘발유(무연),비사업용,68442,147,62,0,68651
2007,서초구,휘발유(무연),사업용,100,0,0,0,100
2007,서초구,휘발유(유연),비사업용,8,0,0,0,8
2007,강남구,CNG,비사업용,3,5,4,0,12
2007,강남구,CNG,사업용,0,48,0,0,48
2007,강남구,경유,비사업용,28070,5533,16628,63,50294
2007,강남구,경유,사업용,1400,771,1492,84,3747
2007,강남구,기타연료,비사업용,26,6,52,32,116
2007,강남구,기타연료,사업용,0,0,85,1,86
2007,강남구,알코올,비사업용,0,0,1,0,1
2007,강남구,알코올,사업용,2,0,0,0,2
2007,강남구,엘피지,비사업용,9107,3889,2162,0,15158
2007,강남구,엘피지,사업용,7210,12,122,0,7344
2007,강남구,전기,비사업용,0,0,1,0,1
2007,강남구,휘발유,비사업용,64219,73,135,0,64427
2007,강남구,휘발유,사업용,3136,5,0,0,3141
2007,강남구,휘발유(무연),비사업용,97561,230,135,1,97927
2007,강남구,휘발유(무연),사업용,583,0,0,0,583
2007,강남구,휘발유(유연),비사업용,3,0,0,0,3
2007,송파구,CNG,비사업용,3,0,13,0,16
2007,송파구,CNG,사업용,1,530,0,0,531
2007,송파구,경유,비사업용,27014,5999,19750,79,52842
2007,송파구,경유,사업용,74,769,3012,109,3964
2007,송파구,기타연료,비사업용,4,1,76,14,95
2007,송파구,기타연료,사업용,0,0,49,0,49
2007,송파구,알코올,비사업용,0,0,2,0,2
2007,송파구,엘피지,비사업용,11832,4509,2962,0,19303
2007,송파구,엘피지,사업용,4515,0,416,0,4931
2007,송파구,태양열,비사업용,1,0,0,0,1
2007,송파구,휘발유,비사업용,34332,20,70,0,34422
2007,송파구,휘발유,사업용,134,1,0,0,135
2007,송파구,휘발유(무연),비사업용,76749,118,82,0,76949
2007,송파구,휘발유(무연),사업용,39,1,2,0,42
2007,송파구,휘발유(유연),비사업용,2,0,0,0,2
2007,강동구,CNG,비사업용,0,0,4,0,4
2007,강동구,CNG,사업용,0,140,0,0,140
2007,강동구,경유,비사업용,18495,4502,13762,31,36790
2007,강동구,경유,사업용,162,411,1758,80,2411
2007,강동구,기타연료,비사업용,8,2,10,2,22
2007,강동구,기타연료,사업용,0,33,38,0,71
2007,강동구,등유,비사업용,1,0,0,0,1
2007,강동구,엘피지,비사업용,10248,3225,2194,1,15668
2007,강동구,엘피지,사업용,5071,3,413,1,5488
2007,강동구,휘발유,비사업용,19212,24,47,0,19283
2007,강동구,휘발유,사업용,643,0,0,0,643
2007,강동구,휘발유(무연),비사업용,48524,69,74,0,48667
2007,강동구,휘발유(무연),사업용,14,0,0,0,14
2007,강동구,휘발유(유연),비사업용,3,0,0,0,3
2008,합계,계,계,2375173,191335,379247,3456,2949211
2008,종로구,CNG,비사업용,3,4,12,0,19
2008,종로구,CNG,사업용,1,92,0,0,93
2008,종로구,경유,비사업용,8874,3299,5974,63,18210
2008,종로구,경유,사업용,3923,908,276,21,5128
2008,종로구,기타연료,비사업용,6,4,10,3,23
2008,종로구,기타연료,사업용,0,0,39,0,39
2008,종로구,엘피지,비사업용,2632,1139,761,0,4532
2008,종로구,엘피지,사업용,6707,19,73,0,6799
2008,종로구,하이브리드(휘발유+전기),비사업용,195,0,0,0,195
2008,종로구,하이브리드(휘발유+전기),사업용,3,0,0,0,3
2008,종로구,휘발유,비사업용,17929,32,46,0,18007
2008,종로구,휘발유,사업용,8733,4,0,0,8737
2008,종로구,휘발유(무연),비사업용,18866,64,31,1,18962
2008,종로구,휘발유(무연),사업용,1756,0,0,0,1756
2008,종로구,휘발유(유연),비사업용,1,0,0,0,1
2008,중구,CNG,비사업용,1,6,7,0,14
2008,중구,경유,비사업용,10188,2674,5733,48,18643
2008,중구,경유,사업용,502,233,1439,61,2235
2008,중구,기타연료,비사업용,6,2,15,5,28
2008,중구,기타연료,사업용,0,0,158,0,158
2008,중구,엘피지,비사업용,2319,1649,737,3,4708
2008,중구,엘피지,사업용,869,5,132,0,1006
2008,중구,하이브리드(휘발유+전기),비사업용,148,0,0,0,148
2008,중구,휘발유,비사업용,22985,18,20,0,23023
2008,중구,휘발유,사업용,1106,3,0,0,1109
2008,중구,휘발유(무연),비사업용,18461,52,39,0,18552
2008,중구,휘발유(무연),사업용,163,0,0,0,163
2008,중구,휘발유(유연),비사업용,1,0,0,0,1
2008,용산구,CNG,비사업용,4,2,17,0,23
2008,용산구,CNG,사업용,0,61,0,0,61
2008,용산구,경유,비사업용,9489,2423,6540,23,18475
2008,용산구,경유,사업용,720,226,941,42,1929
2008,용산구,기타연료,비사업용,1787,4,33,1,1825
2008,용산구,기타연료,사업용,0,0,38,0,38
2008,용산구,엘피지,비사업용,3836,1528,994,1,6359
2008,용산구,엘피지,사업용,1694,4,137,0,1835
2008,용산구,하이브리드(휘발유+전기),비사업용,34,0,0,0,34
2008,용산구,휘발유,비사업용,17073,24,68,0,17165
2008,용산구,휘발유,사업용,621,0,0,0,621
2008,용산구,휘발유(무연),비사업용,27553,96,51,0,27700
2008,용산구,휘발유(무연),사업용,99,0,0,0,99
2008,용산구,휘발유(유연),비사업용,2,0,0,0,2
2008,성동구,CNG,비사업용,4,1,9,0,14
2008,성동구,CNG,사업용,0,121,0,0,121
2008,성동구,경유,비사업용,12484,2835,9144,36,24499
2008,성동구,경유,사업용,34,208,1402,108,1752
2008,성동구,기타연료,비사업용,5,4,10,1,20
2008,성동구,기타연료,사업용,0,0,9,0,9
2008,성동구,엘피지,비사업용,6280,2149,1667,1,10097
2008,성동구,엘피지,사업용,2517,1,350,2,2870
2008,성동구,하이브리드(휘발유+전기),비사업용,34,0,0,0,34
2008,성동구,휘발유,비사업용,15740,10,26,1,15777
2008,성동구,휘발유,사업용,237,0,0,0,237
2008,성동구,휘발유(무연),비사업용,29705,52,27,1,29785
2008,성동구,휘발유(무연),사업용,42,0,1,0,43
2008,성동구,휘발유(유연),비사업용,1,0,0,0,1
2008,광진구,CNG,비사업용,0,1,9,0,10
2008,광진구,CNG,사업용,0,2,0,0,2
2008,광진구,경유,비사업용,13539,3346,9179,24,26088
2008,광진구,경유,사업용,21,272,1090,29,1412
2008,광진구,기타연료,비사업용,3,0,12,1,16
2008,광진구,기타연료,사업용,0,0,3,0,3
2008,광진구,엘피지,비사업용,6583,2553,1846,0,10982
2008,광진구,엘피지,사업용,2206,0,308,0,2514
2008,광진구,하이브리드(휘발유+전기),비사업용,22,0,0,0,22
2008,광진구,휘발유,비사업용,16199,11,24,0,16234
2008,광진구,휘발유,사업용,31,0,0,0,31
2008,광진구,휘발유(무연),비사업용,33599,61,45,0,33705
2008,광진구,휘발유(무연),사업용,7,0,0,0,7
2008,광진구,휘발유(유연),비사업용,1,0,0,0,1
2008,동대문구,CNG,비사업용,0,1,13,0,14
2008,동대문구,CNG,사업용,0,1,0,0,1
2008,동대문구,경유,비사업용,13733,3678,10332,33,27776
2008,동대문구,경유,사업용,20,188,1925,45,2178
2008,동대문구,기타연료,비사업용,3,1,8,2,14
2008,동대문구,기타연료,사업용,0,0,6,0,6
2008,동대문구,엘피지,비사업용,6867,2532,2098,1,11498
2008,동대문구,엘피지,사업용,2870,2,462,0,3334
2008,동대문구,하이브리드(휘발유+전기),비사업용,22,0,0,0,22
2008,동대문구,휘발유,비사업용,14366,10,34,0,14410
2008,동대문구,휘발유,사업용,91,0,0,0,91
2008,동대문구,휘발유(무연),비사업용,29703,55,42,0,29800
2008,동대문구,휘발유(무연),사업용,17,0,0,0,17
2008,동대문구,휘발유(유연),비사업용,2,0,0,0,2
2008,중랑구,CNG,비사업용,4,0,16,0,20
2008,중랑구,CNG,사업용,0,690,0,0,690
2008,중랑구,경유,비사업용,14656,4138,11539,32,30365
2008,중랑구,경유,사업용,28,306,2086,118,2538
2008,중랑구,기타연료,비사업용,2,4,7,1,14
2008,중랑구,기타연료,사업용,0,1,3,0,4
2008,중랑구,엘피지,비사업용,8501,3252,2748,0,14501
2008,중랑구,엘피지,사업용,5480,1,552,4,6037
2008,중랑구,하이브리드(휘발유+전기),비사업용,22,0,0,0,22
2008,중랑구,휘발유,비사업용,13985,17,30,0,14032
2008,중랑구,휘발유,사업용,25,0,0,0,25
2008,중랑구,휘발유(무연),비사업용,33528,73,39,0,33640
2008,중랑구,휘발유(무연),사업용,4,0,2,0,6
2008,중랑구,휘발유(유연),비사업용,1,0,0,0,1
2008,성북구,CNG,비사업용,0,1,3,0,4
2008,성북구,CNG,사업용,0,649,0,0,649
2008,성북구,경유,비사업용,17386,4198,9390,25,30999
2008,성북구,경유,사업용,12,338,1346,14,1710
2008,성북구,기타연료,비사업용,3,2,17,2,24
2008,성북구,엘피지,비사업용,8755,3140,2075,1,13971
2008,성북구,엘피지,사업용,2739,1,419,0,3159
2008,성북구,하이브리드(휘발유+전기),비사업용,29,0,0,0,29
2008,성북구,휘발유,비사업용,18693,14,38,0,18745
2008,성북구,휘발유,사업용,15,1,0,0,16
2008,성북구,휘발유(무연),비사업용,40377,79,40,0,40496
2008,성북구,휘발유(무연),사업용,0,0,1,0,1
2008,성북구,휘발유(유연),비사업용,2,0,0,0,2
2008,강북구,CNG,비사업용,2,1,9,0,12
2008,강북구,CNG,사업용,0,489,0,0,489
2008,강북구,경유,비사업용,10371,3032,7191,26,20620
2008,강북구,경유,사업용,7,247,1056,13,1323
2008,강북구,기타연료,비사업용,0,1,2,0,3
2008,강북구,기타연료,사업용,0,4,1,0,5
2008,강북구,엘피지,비사업용,6516,2475,1858,0,10849
2008,강북구,엘피지,사업용,2604,1,431,0,3036
2008,강북구,하이브리드(휘발유+전기),비사업용,22,0,0,0,22
2008,강북구,휘발유,비사업용,9897,12,25,0,9934
2008,강북구,휘발유,사업용,1,0,0,0,1
2008,강북구,휘발유(무연),비사업용,25038,42,25,0,25105
2008,강북구,휘발유(무연),사업용,1,0,0,0,1
2008,강북구,휘발유(유연),비사업용,2,0,0,0,2
2008,도봉구,CNG,비사업용,4,1,7,0,12
2008,도봉구,CNG,사업용,2,368,0,0,370
2008,도봉구,경유,비사업용,13488,3319,8332,15,25154
2008,도봉구,경유,사업용,25,230,1037,47,1339
2008,도봉구,기타연료,비사업용,2,0,10,1,13
2008,도봉구,기타연료,사업용,0,0,3,0,3
2008,도봉구,엘피지,비사업용,7804,2909,1977,0,12690
2008,도봉구,엘피지,사업용,5662,3,292,0,5957
2008,도봉구,하이브리드(휘발유+전기),비사업용,38,0,0,0,38
2008,도봉구,휘발유,비사업용,13646,8,19,0,13673
2008,도봉구,휘발유,사업용,16,0,0,0,16
2008,도봉구,휘발유(무연),비사업용,34220,55,36,0,34311
2008,도봉구,휘발유(무연),사업용,8,0,1,0,9
2008,도봉구,휘발유(유연),비사업용,2,0,0,0,2
2008,노원구,CNG,비사업용,8,2,6,0,16
2008,노원구,CNG,사업용,0,484,0,0,484
2008,노원구,경유,비사업용,23308,5324,11455,32,40119
2008,노원구,경유,사업용,33,312,1483,43,1871
2008,노원구,기타연료,비사업용,3,6,10,2,21
2008,노원구,기타연료,사업용,0,0,6,0,6
2008,노원구,엘피지,비사업용,13845,4343,2592,0,20780
2008,노원구,엘피지,사업용,6864,1,455,0,7320
2008,노원구,하이브리드(휘발유+전기),비사업용,47,0,0,0,47
2008,노원구,휘발유,비사업용,23633,12,37,0,23682
2008,노원구,휘발유,사업용,28,0,0,0,28
2008,노원구,휘발유(무연),비사업용,59222,95,41,0,59358
2008,노원구,휘발유(무연),사업용,2,0,4,0,6
2008,노원구,휘발유(유연),비사업용,2,0,0,0,2
2008,은평구,CNG,비사업용,1,3,11,0,15
2008,은평구,CNG,사업용,0,422,0,0,422
2008,은평구,경유,비사업용,15317,4337,10762,21,30437
2008,은평구,경유,사업용,10,282,1338,64,1694
2008,은평구,기타연료,비사업용,2,1,4,1,8
2008,은평구,기타연료,사업용,0,0,2,1,3
2008,은평구,엘피지,비사업용,8746,3226,2139,0,14111
2008,은평구,엘피지,사업용,3732,1,344,1,4078
2008,은평구,태양열,비사업용,1,0,0,0,1
2008,은평구,하이브리드(휘발유+전기),비사업용,39,0,0,0,39
2008,은평구,휘발유,비사업용,16948,26,32,0,17006
2008,은평구,휘발유,사업용,5,0,0,0,5
2008,은평구,휘발유(무연),비사업용,39365,88,54,0,39507
2008,은평구,휘발유(무연),사업용,1,0,2,0,3
2008,은평구,휘발유(유연),비사업용,1,0,0,0,1
2008,서대문구,CNG,비사업용,1,2,8,0,11
2008,서대문구,CNG,사업용,0,242,0,0,242
2008,서대문구,경유,비사업용,11682,3057,7046,36,21821
2008,서대문구,경유,사업용,5,145,1620,86,1856
2008,서대문구,기타연료,비사업용,4,0,4,0,8
2008,서대문구,기타연료,사업용,0,9,14,0,23
2008,서대문구,엘피지,비사업용,5886,2169,1373,0,9428
2008,서대문구,엘피지,사업용,2552,0,280,0,2832
2008,서대문구,하이브리드(휘발유+전기),비사업용,38,0,0,0,38
2008,서대문구,휘발유,비사업용,13558,15,31,0,13604
2008,서대문구,휘발유,사업용,7,0,0,0,7
2008,서대문구,휘발유(무연),비사업용,30075,64,34,0,30173
2008,서대문구,휘발유(무연),사업용,7,0,0,0,7
2008,서대문구,휘발유(유연),비사업용,2,0,0,0,2
2008,마포구,CNG,비사업용,0,3,11,0,14
2008,마포구,CNG,사업용,0,279,0,0,279
2008,마포구,LNG,사업용,0,0,1,0,1
2008,마포구,경유,비사업용,15863,3739,10082,54,29738
2008,마포구,경유,사업용,159,372,2382,87,3000
2008,마포구,기타연료,비사업용,3,2,31,11,47
2008,마포구,기타연료,사업용,0,0,42,0,42
2008,마포구,엘피지,비사업용,7100,2712,1837,2,11651
2008,마포구,엘피지,사업용,2785,3,243,0,3031
2008,마포구,하이브리드(휘발유+전기),비사업용,28,0,0,0,28
2008,마포구,휘발유,비사업용,20250,22,42,0,20314
2008,마포구,휘발유,사업용,309,0,0,0,309
2008,마포구,휘발유(무연),비사업용,39244,62,58,0,39364
2008,마포구,휘발유(무연),사업용,28,0,0,0,28
2008,마포구,휘발유(유연),비사업용,1,0,0,0,1
2008,양천구,CNG,비사업용,3,0,5,0,8
2008,양천구,CNG,사업용,0,434,0,0,434
2008,양천구,경유,비사업용,20324,4732,12891,78,38025
2008,양천구,경유,사업용,22,417,2250,310,2999
2008,양천구,기타연료,비사업용,3,5,16,2,26
2008,양천구,기타연료,사업용,0,0,136,0,136
2008,양천구,엘피지,비사업용,10276,3744,2629,1,16650
2008,양천구,엘피지,사업용,4847,3,382,0,5232
2008,양천구,하이브리드(휘발유+전기),비사업용,22,0,0,0,22
2008,양천구,휘발유,비사업용,24931,21,21,0,24973
2008,양천구,휘발유,사업용,38,0,0,0,38
2008,양천구,휘발유(무연),비사업용,54961,72,61,1,55095
2008,양천구,휘발유(무연),사업용,45,0,2,0,47
2008,양천구,휘발유(유연),비사업용,2,0,0,0,2
2008,강서구,CNG,비사업용,3,2,12,0,17
2008,강서구,CNG,사업용,4,266,0,0,270
2008,강서구,경유,비사업용,23607,5540,16185,81,45413
2008,강서구,경유,사업용,862,829,2279,74,4044
2008,강서구,기타연료,비사업용,10,5,50,2,67
2008,강서구,기타연료,사업용,0,0,14,0,14
2008,강서구,엘피지,비사업용,14513,4825,3500,1,22839
2008,강서구,엘피지,사업용,7475,2,432,0,7909
2008,강서구,하이브리드(휘발유+전기),비사업용,39,0,0,0,39
2008,강서구,하이브리드(휘발유+전기),사업용,1,0,0,0,1
2008,강서구,휘발유,비사업용,27116,18,31,0,27165
2008,강서구,휘발유,사업용,2832,4,0,0,2836
2008,강서구,휘발유(무연),비사업용,61150,95,64,0,61309
2008,강서구,휘발유(무연),사업용,458,2,0,0,460
2008,강서구,휘발유(유연),비사업용,1,1,0,0,2
2008,구로구,CNG,비사업용,0,0,8,0,8
2008,구로구,CNG,사업용,0,142,0,0,142
2008,구로구,경유,비사업용,19249,4766,14312,31,38358
2008,구로구,경유,사업용,3244,806,1576,78,5704
2008,구로구,기타연료,비사업용,0,3,10,1,14
2008,구로구,기타연료,사업용,0,0,13,0,13
2008,구로구,엘피지,비사업용,9236,3265,2355,5,14861
2008,구로구,엘피지,사업용,8579,51,344,1,8975
2008,구로구,하이브리드(휘발유+전기),비사업용,23,0,0,0,23
2008,구로구,하이브리드(휘발유+전기),사업용,1,0,0,0,1
2008,구로구,휘발유,비사업용,19003,12,36,0,19051
2008,구로구,휘발유,사업용,5153,0,0,0,5153
2008,구로구,휘발유(무연),비사업용,42121,55,58,0,42234
2008,구로구,휘발유(무연),사업용,1321,0,1,0,1322
2008,구로구,휘발유(유연),비사업용,3,0,0,0,3
2008,금천구,CNG,비사업용,1,1,11,0,13
2008,금천구,CNG,사업용,0,246,0,0,246
2008,금천구,경유,비사업용,10700,3089,9578,21,23388
2008,금천구,경유,사업용,19,181,1973,38,2211
2008,금천구,기타연료,비사업용,1,0,6,0,7
2008,금천구,기타연료,사업용,0,0,7,0,7
2008,금천구,엘피지,비사업용,5239,2038,1778,2,9057
2008,금천구,엘피지,사업용,2380,0,309,0,2689
2008,금천구,하이브리드(휘발유+전기),비사업용,14,0,0,0,14
2008,금천구,휘발유,비사업용,10633,10,40,0,10683
2008,금천구,휘발유,사업용,21,0,0,0,21
2008,금천구,휘발유(무연),비사업용,22796,33,34,0,22863
2008,금천구,휘발유(무연),사업용,49,0,0,0,49
2008,금천구,휘발유(유연),비사업용,1,0,0,0,1
2008,영등포구,CNG,비사업용,3,2,13,0,18
2008,영등포구,CNG,사업용,2,69,0,0,71
2008,영등포구,경유,비사업용,23692,5277,16977,165,46111
2008,영등포구,경유,사업용,584,564,3432,340,4920
2008,영등포구,기타연료,비사업용,10,4,19,3,36
2008,영등포구,기타연료,사업용,0,0,116,3,119
2008,영등포구,엘피지,비사업용,8793,3055,2309,1,14158
2008,영등포구,엘피지,사업용,6376,15,421,3,6815
2008,영등포구,하이브리드(휘발유+전기),비사업용,71,0,0,0,71
2008,영등포구,휘발유,비사업용,27779,31,58,1,27869
2008,영등포구,휘발유,사업용,614,0,0,0,614
2008,영등포구,휘발유(무연),비사업용,45638,78,67,2,45785
2008,영등포구,휘발유(무연),사업용,132,0,0,0,132
2008,영등포구,휘발유(유연),비사업용,3,0,0,0,3
2008,동작구,CNG,비사업용,1,0,10,0,11
2008,동작구,CNG,사업용,0,37,0,0,37
2008,동작구,경유,비사업용,14050,3108,7922,28,25108
2008,동작구,경유,사업용,4,113,1053,29,1199
2008,동작구,기타연료,비사업용,7,0,10,2,19
2008,동작구,기타연료,사업용,0,0,4,0,4
2008,동작구,엘피지,비사업용,7596,2437,1593,1,11627
2008,동작구,엘피지,사업용,1379,0,227,0,1606
2008,동작구,하이브리드(휘발유+전기),비사업용,27,0,0,0,27
2008,동작구,휘발유,비사업용,17465,15,20,0,17500
2008,동작구,휘발유,사업용,1,0,0,0,1
2008,동작구,휘발유(무연),비사업용,37399,50,31,0,37480
2008,동작구,휘발유(무연),사업용,0,0,1,0,1
2008,동작구,휘발유(유연),비사업용,3,0,0,0,3
2008,관악구,CNG,비사업용,0,0,7,0,7
2008,관악구,CNG,사업용,0,105,0,0,105
2008,관악구,경유,비사업용,17841,4455,10460,27,32783
2008,관악구,경유,사업용,221,226,1697,56,2200
2008,관악구,기타연료,비사업용,3,0,16,1,20
2008,관악구,기타연료,사업용,0,0,6,0,6
2008,관악구,엘피지,비사업용,9668,3392,2359,0,15419
2008,관악구,엘피지,사업용,3053,2,396,0,3451
2008,관악구,하이브리드(휘발유+전기),비사업용,33,0,0,0,33
2008,관악구,휘발유,비사업용,19480,14,33,1,19528
2008,관악구,휘발유,사업용,158,0,0,0,158
2008,관악구,휘발유(무연),비사업용,44848,58,42,0,44948
2008,관악구,휘발유(무연),사업용,17,0,2,0,19
2008,서초구,CNG,비사업용,3,0,5,0,8
2008,서초구,CNG,사업용,12,230,0,0,242
2008,서초구,경유,비사업용,20190,4040,12943,106,37279
2008,서초구,경유,사업용,670,428,4321,128,5547
2008,서초구,기타연료,비사업용,14,6,45,3,68
2008,서초구,기타연료,사업용,0,0,128,3,131
2008,서초구,등유,비사업용,1,0,0,0,1
2008,서초구,엘피지,비사업용,6453,2558,1628,0,10639
2008,서초구,엘피지,사업용,3078,10,215,0,3303
2008,서초구,하이브리드(휘발유+전기),비사업용,107,0,0,0,107
2008,서초구,휘발유,비사업용,45093,60,67,0,45220
2008,서초구,휘발유,사업용,1799,1,0,0,1800
2008,서초구,휘발유(무연),비사업용,62297,123,59,0,62479
2008,서초구,휘발유(무연),사업용,257,0,0,0,257
2008,서초구,휘발유(유연),비사업용,5,0,0,0,5
2008,강남구,CNG,비사업용,10,9,9,0,28
2008,강남구,CNG,사업용,0,81,0,0,81
2008,강남구,경유,비사업용,29422,5361,15799,65,50647
2008,강남구,경유,사업용,985,732,1232,103,3052
2008,강남구,기타연료,비사업용,25,6,35,22,88
2008,강남구,기타연료,사업용,0,11,102,1,114
2008,강남구,엘피지,비사업용,9467,3645,2276,2,15390
2008,강남구,엘피지,사업용,6562,11,127,0,6700
2008,강남구,하이브리드(휘발유+전기),비사업용,305,0,0,0,305
2008,강남구,휘발유,비사업용,74764,75,138,0,74977
2008,강남구,휘발유,사업용,2296,3,0,0,2299
2008,강남구,휘발유(무연),비사업용,88966,193,120,1,89280
2008,강남구,휘발유(무연),사업용,1001,0,0,0,1001
2008,강남구,휘발유(유연),비사업용,3,0,0,0,3
2008,송파구,CNG,비사업용,11,1,32,0,44
2008,송파구,CNG,사업용,1,618,0,0,619
2008,송파구,경유,비사업용,29349,5973,19110,84,54516
2008,송파구,경유,사업용,83,672,3044,113,3912
2008,송파구,기타연료,비사업용,4,1,78,3,86
2008,송파구,기타연료,사업용,0,0,42,0,42
2008,송파구,엘피지,비사업용,13040,4563,3499,0,21102
2008,송파구,엘피지,사업용,4718,0,495,0,5213
2008,송파구,하이브리드(휘발유+전기),비사업용,48,0,0,0,48
2008,송파구,휘발유,비사업용,41833,23,71,0,41927
2008,송파구,휘발유,사업용,158,2,0,0,160
2008,송파구,휘발유(무연),비사업용,77341,115,78,0,77534
2008,송파구,휘발유(무연),사업용,37,0,2,0,39
2008,송파구,휘발유(유연),비사업용,4,0,0,0,4
2008,강동구,CNG,비사업용,3,0,12,0,15
2008,강동구,CNG,사업용,0,193,0,0,193
2008,강동구,경유,비사업용,19099,4340,12848,27,36314
2008,강동구,경유,사업용,197,374,1655,105,2331
2008,강동구,기타연료,비사업용,5,5,13,2,25
2008,강동구,기타연료,사업용,0,0,52,0,52
2008,강동구,엘피지,비사업용,10658,3320,2725,0,16703
2008,강동구,엘피지,사업용,4674,4,443,1,5122
2008,강동구,하이브리드(휘발유+전기),비사업용,18,0,0,0,18
2008,강동구,휘발유,비사업용,21682,21,45,0,21748
2008,강동구,휘발유,사업용,895,0,0,0,895
2008,강동구,휘발유(무연),비사업용,46474,71,63,0,46608
2008,강동구,휘발유(무연),사업용,118,0,0,0,118
2008,강동구,휘발유(유연),비사업용,2,0,0,0,2
2009,합계,계,계,2394901,185343,370894,3566,2954704
2009,종로구,CNG,비사업용,2,3,15,0,20
2009,종로구,CNG,사업용,2,98,0,0,100
2009,종로구,경유,비사업용,7480,3261,5388,64,16193
2009,종로구,경유,사업용,3833,926,475,20,5254
2009,종로구,기타연료,비사업용,8,4,13,2,27
2009,종로구,기타연료,사업용,0,0,75,0,75
2009,종로구,엘피지,비사업용,2623,1102,735,0,4460
2009,종로구,엘피지,사업용,6517,31,164,0,6712
2009,종로구,하이브리드(LPG+전기),비사업용,55,0,0,0,55
2009,종로구,하이브리드(LPG+전기),사업용,79,0,0,0,79
2009,종로구,하이브리드(휘발유+전기),비사업용,162,0,0,0,162
2009,종로구,하이브리드(휘발유+전기),사업용,5,0,0,0,5
2009,종로구,휘발유,비사업용,12497,22,46,0,12565
2009,종로구,휘발유,사업용,6942,3,0,0,6945
2009,종로구,휘발유(무연),비사업용,16259,56,27,1,16343
2009,종로구,휘발유(무연),사업용,2171,0,0,0,2171
2009,종로구,휘발유(유연),비사업용,1,0,0,0,1
2009,중구,CNG,비사업용,1,5,13,0,19
2009,중구,경유,비사업용,6910,2590,5365,53,14918
2009,중구,경유,사업용,547,249,1578,53,2427
2009,중구,기타연료,비사업용,4,2,15,5,26
2009,중구,기타연료,사업용,0,0,62,0,62
2009,중구,엘피지,비사업용,2232,1246,757,2,4237
2009,중구,엘피지,사업용,966,10,138,0,1114
2009,중구,하이브리드(LPG+전기),비사업용,19,0,0,0,19
2009,중구,하이브리드(휘발유+전기),비사업용,81,0,0,0,81
2009,중구,휘발유,비사업용,12847,17,19,0,12883
2009,중구,휘발유,사업용,1290,3,0,0,1293
2009,중구,휘발유(무연),비사업용,15446,46,34,0,15526
2009,중구,휘발유(무연),사업용,353,0,1,0,354
2009,중구,휘발유(유연),비사업용,1,0,0,0,1
2009,용산구,CNG,비사업용,5,2,23,0,30
2009,용산구,CNG,사업용,0,1,0,0,1
2009,용산구,경유,비사업용,9952,2313,6076,20,18361
2009,용산구,경유,사업용,263,153,897,43,1356
2009,용산구,기타연료,비사업용,1918,4,30,1,1953
2009,용산구,기타연료,사업용,0,0,42,0,42
2009,용산구,엘피지,비사업용,3980,1522,1039,1,6542
2009,용산구,엘피지,사업용,1034,2,149,0,1185
2009,용산구,하이브리드(LPG+전기),비사업용,43,0,0,0,43
2009,용산구,하이브리드(휘발유+전기),비사업용,45,0,0,0,45
2009,용산구,휘발유,비사업용,19519,19,62,0,19600
2009,용산구,휘발유,사업용,229,0,0,0,229
2009,용산구,휘발유(무연),비사업용,26388,77,42,0,26507
2009,용산구,휘발유(무연),사업용,46,0,0,0,46
2009,용산구,휘발유(유연),비사업용,1,0,0,0,1
2009,성동구,CNG,비사업용,7,3,15,0,25
2009,성동구,CNG,사업용,0,150,0,0,150
2009,성동구,경유,비사업용,12982,2628,8357,33,24000
2009,성동구,경유,사업용,37,165,1300,84,1586
2009,성동구,기타연료,비사업용,3,3,14,1,21
2009,성동구,기타연료,사업용,0,0,9,0,9
2009,성동구,엘피지,비사업용,7321,1999,1711,1,11032
2009,성동구,엘피지,사업용,2401,0,375,0,2776
2009,성동구,하이브리드(LPG+전기),비사업용,32,0,0,0,32
2009,성동구,하이브리드(휘발유+전기),비사업용,51,0,0,0,51
2009,성동구,휘발유,비사업용,17338,3,14,0,17355
2009,성동구,휘발유,사업용,234,0,0,0,234
2009,성동구,휘발유(무연),비사업용,28271,44,22,0,28337
2009,성동구,휘발유(무연),사업용,39,0,0,0,39
2009,광진구,CNG,비사업용,3,2,11,0,16
2009,광진구,CNG,사업용,0,5,0,0,5
2009,광진구,경유,비사업용,13974,3227,9267,26,26494
2009,광진구,경유,사업용,178,348,1069,31,1626
2009,광진구,기타연료,비사업용,4,1,11,1,17
2009,광진구,기타연료,사업용,0,0,1,0,1
2009,광진구,엘피지,비사업용,6790,2505,1930,0,11225
2009,광진구,엘피지,사업용,2514,1,315,0,2830
2009,광진구,하이브리드(LPG+전기),비사업용,36,0,0,0,36
2009,광진구,하이브리드(LPG+전기),사업용,23,0,0,0,23
2009,광진구,하이브리드(휘발유+전기),비사업용,27,0,0,0,27
2009,광진구,휘발유,비사업용,19042,11,24,0,19077
2009,광진구,휘발유,사업용,249,0,0,0,249
2009,광진구,휘발유(무연),비사업용,31718,58,41,0,31817
2009,광진구,휘발유(무연),사업용,101,0,2,0,103
2009,광진구,휘발유(유연),비사업용,1,0,0,0,1
2009,동대문구,CNG,비사업용,2,2,16,0,20
2009,동대문구,CNG,사업용,0,4,0,0,4
2009,동대문구,경유,비사업용,14085,3528,9817,34,27464
2009,동대문구,경유,사업용,23,183,1793,43,2042
2009,동대문구,기타연료,비사업용,2,4,11,2,19
2009,동대문구,기타연료,사업용,0,0,5,0,5
2009,동대문구,엘피지,비사업용,7256,2310,2202,0,11768
2009,동대문구,엘피지,사업용,2883,2,488,0,3373
2009,동대문구,하이브리드(LPG+전기),비사업용,35,0,0,0,35
2009,동대문구,하이브리드(휘발유+전기),비사업용,29,0,0,0,29
2009,동대문구,휘발유,비사업용,16446,11,32,0,16489
2009,동대문구,휘발유,사업용,36,0,0,0,36
2009,동대문구,휘발유(무연),비사업용,28009,52,37,0,28098
2009,동대문구,휘발유(무연),사업용,94,0,0,0,94
2009,동대문구,휘발유(유연),비사업용,4,0,0,0,4
2009,중랑구,CNG,비사업용,4,2,20,0,26
2009,중랑구,CNG,사업용,1,752,0,0,753
2009,중랑구,경유,비사업용,15232,3935,11029,30,30226
2009,중랑구,경유,사업용,27,258,2071,140,2496
2009,중랑구,기타연료,비사업용,2,4,10,1,17
2009,중랑구,기타연료,사업용,0,1,4,0,5
2009,중랑구,엘피지,비사업용,8927,3262,2893,0,15082
2009,중랑구,엘피지,사업용,5373,0,572,6,5951
2009,중랑구,하이브리드(LPG+전기),비사업용,30,0,0,0,30
2009,중랑구,하이브리드(휘발유+전기),비사업용,24,0,0,0,24
2009,중랑구,휘발유,비사업용,15920,16,25,0,15961
2009,중랑구,휘발유,사업용,24,0,0,0,24
2009,중랑구,휘발유(무연),비사업용,31984,67,33,0,32084
2009,중랑구,휘발유(무연),사업용,3,0,2,0,5
2009,중랑구,휘발유(유연),비사업용,1,0,0,0,1
2009,성북구,CNG,비사업용,0,2,6,0,8
2009,성북구,CNG,사업용,0,701,0,0,701
2009,성북구,경유,비사업용,18447,4090,9130,29,31696
2009,성북구,경유,사업용,11,249,1308,20,1588
2009,성북구,기타연료,비사업용,3,5,25,2,35
2009,성북구,엘피지,비사업용,9082,3074,2115,2,14273
2009,성북구,엘피지,사업용,2724,1,439,0,3164
2009,성북구,하이브리드(LPG+전기),비사업용,40,0,0,0,40
2009,성북구,하이브리드(휘발유+전기),비사업용,35,0,0,0,35
2009,성북구,휘발유,비사업용,21838,16,38,0,21892
2009,성북구,휘발유,사업용,16,1,0,0,17
2009,성북구,휘발유(무연),비사업용,38862,61,34,0,38957
2009,성북구,휘발유(무연),사업용,0,0,1,0,1
2009,성북구,휘발유(유연),비사업용,2,0,0,0,2
2009,강북구,CNG,비사업용,1,1,12,0,14
2009,강북구,CNG,사업용,0,578,0,0,578
2009,강북구,경유,비사업용,10832,2902,6901,24,20659
2009,강북구,경유,사업용,7,143,979,11,1140
2009,강북구,기타연료,비사업용,0,2,8,0,10
2009,강북구,기타연료,사업용,0,4,0,0,4
2009,강북구,등유,비사업용,1,0,0,0,1
2009,강북구,엘피지,비사업용,6854,2465,1923,0,11242
2009,강북구,엘피지,사업용,2600,1,458,0,3059
2009,강북구,하이브리드(LPG+전기),비사업용,17,0,0,0,17
2009,강북구,하이브리드(휘발유+전기),비사업용,24,0,0,0,24
2009,강북구,휘발유,비사업용,11060,12,23,0,11095
2009,강북구,휘발유,사업용,1,0,0,0,1
2009,강북구,휘발유(무연),비사업용,24030,44,20,0,24094
2009,강북구,휘발유(무연),사업용,1,0,0,0,1
2009,강북구,휘발유(유연),비사업용,1,0,0,0,1
2009,도봉구,CNG,비사업용,5,2,7,0,14
2009,도봉구,CNG,사업용,5,388,0,0,393
2009,도봉구,LNG,비사업용,1,0,0,0,1
2009,도봉구,경유,비사업용,14173,3168,7969,17,25327
2009,도봉구,경유,사업용,31,192,987,54,1264
2009,도봉구,기타연료,비사업용,3,3,12,1,19
2009,도봉구,기타연료,사업용,0,0,3,0,3
2009,도봉구,엘피지,비사업용,8132,2792,2111,0,13035
2009,도봉구,엘피지,사업용,5603,2,284,0,5889
2009,도봉구,하이브리드(LPG+전기),비사업용,40,0,0,0,40
2009,도봉구,하이브리드(휘발유+전기),비사업용,39,0,0,0,39
2009,도봉구,휘발유,비사업용,15606,7,16,0,15629
2009,도봉구,휘발유,사업용,30,0,0,0,30
2009,도봉구,휘발유(무연),비사업용,32345,50,28,0,32423
2009,도봉구,휘발유(무연),사업용,7,0,0,0,7
2009,도봉구,휘발유(유연),비사업용,3,0,0,0,3
2009,노원구,CNG,비사업용,11,3,8,0,22
2009,노원구,CNG,사업용,0,529,0,0,529
2009,노원구,경유,비사업용,24418,4991,10944,28,40381
2009,노원구,경유,사업용,45,252,1418,51,1766
2009,노원구,기타연료,비사업용,3,9,15,2,29
2009,노원구,기타연료,사업용,0,0,7,0,7
2009,노원구,엘피지,비사업용,14375,4107,2755,0,21237
2009,노원구,엘피지,사업용,6754,0,484,0,7238
2009,노원구,하이브리드(LPG+전기),비사업용,61,0,0,0,61
2009,노원구,하이브리드(휘발유+전기),비사업용,52,0,0,0,52
2009,노원구,휘발유,비사업용,27565,12,34,0,27611
2009,노원구,휘발유,사업용,82,0,0,0,82
2009,노원구,휘발유(무연),비사업용,55634,84,39,0,55757
2009,노원구,휘발유(무연),사업용,24,0,3,0,27
2009,노원구,휘발유(유연),비사업용,2,0,0,0,2
2009,은평구,CNG,비사업용,2,2,15,0,19
2009,은평구,CNG,사업용,0,511,0,0,511
2009,은평구,경유,비사업용,16533,4160,10337,23,31053
2009,은평구,경유,사업용,13,192,1253,49,1507
2009,은평구,기타연료,비사업용,3,3,14,1,21
2009,은평구,기타연료,사업용,0,0,1,1,2
2009,은평구,엘피지,비사업용,9500,3226,2354,1,15081
2009,은평구,엘피지,사업용,3737,1,375,1,4114
2009,은평구,태양열,비사업용,1,0,0,0,1
2009,은평구,하이브리드(LPG+전기),비사업용,49,0,0,0,49
2009,은평구,하이브리드(LPG+전기),사업용,2,0,0,0,2
2009,은평구,하이브리드(휘발유+전기),비사업용,40,0,0,0,40
2009,은평구,휘발유,비사업용,19516,23,30,0,19569
2009,은평구,휘발유,사업용,9,0,0,0,9
2009,은평구,휘발유(무연),비사업용,38604,76,49,0,38729
2009,은평구,휘발유(무연),사업용,2,0,1,0,3
2009,은평구,휘발유(유연),비사업용,2,0,0,0,2
2009,서대문구,CNG,비사업용,3,2,11,0,16
2009,서대문구,CNG,사업용,0,278,0,0,278
2009,서대문구,경유,비사업용,12195,2901,6640,31,21767
2009,서대문구,경유,사업용,4,112,1328,46,1490
2009,서대문구,기타연료,비사업용,3,1,3,0,7
2009,서대문구,기타연료,사업용,0,8,16,0,24
2009,서대문구,엘피지,비사업용,6020,2093,1417,0,9530
2009,서대문구,엘피지,사업용,2548,0,245,0,2793
2009,서대문구,하이브리드(LPG+전기),비사업용,39,0,0,0,39
2009,서대문구,하이브리드(휘발유+전기),비사업용,46,0,0,0,46
2009,서대문구,휘발유,비사업용,15673,14,32,0,15719
2009,서대문구,휘발유,사업용,14,0,0,0,14
2009,서대문구,휘발유(무연),비사업용,28375,50,27,0,28452
2009,서대문구,휘발유(무연),사업용,9,0,0,0,9
2009,서대문구,휘발유(유연),비사업용,2,0,0,0,2
2009,마포구,CNG,비사업용,2,3,12,0,17
2009,마포구,CNG,사업용,7,287,0,0,294
2009,마포구,경유,비사업용,16469,3633,9764,70,29936
2009,마포구,경유,사업용,115,328,2230,84,2757
2009,마포구,기타연료,비사업용,5,3,34,13,55
2009,마포구,기타연료,사업용,0,0,44,0,44
2009,마포구,엘피지,비사업용,7190,2657,1880,0,11727
2009,마포구,엘피지,사업용,2691,1,257,0,2949
2009,마포구,하이브리드(LPG+전기),비사업용,36,0,0,0,36
2009,마포구,하이브리드(휘발유+전기),비사업용,36,0,0,0,36
2009,마포구,휘발유,비사업용,23085,23,45,0,23153
2009,마포구,휘발유,사업용,344,0,0,0,344
2009,마포구,휘발유(무연),비사업용,36829,62,55,0,36946
2009,마포구,휘발유(무연),사업용,62,0,0,0,62
2009,마포구,휘발유(유연),비사업용,1,0,0,0,1
2009,양천구,CNG,비사업용,2,0,9,0,11
2009,양천구,CNG,사업용,0,539,0,0,539
2009,양천구,경유,비사업용,21244,4437,12421,88,38190
2009,양천구,경유,사업용,26,307,2283,305,2921
2009,양천구,기타연료,비사업용,3,5,15,2,25
2009,양천구,기타연료,사업용,0,0,119,0,119
2009,양천구,엘피지,비사업용,11238,3741,2745,0,17724
2009,양천구,엘피지,사업용,5033,5,408,0,5446
2009,양천구,하이브리드(LPG+전기),비사업용,51,0,0,0,51
2009,양천구,하이브리드(LPG+전기),사업용,7,0,0,0,7
2009,양천구,하이브리드(휘발유+전기),비사업용,31,0,0,0,31
2009,양천구,휘발유,비사업용,29389,19,20,0,29428
2009,양천구,휘발유,사업용,187,0,0,0,187
2009,양천구,휘발유(무연),비사업용,51701,67,49,1,51818
2009,양천구,휘발유(무연),사업용,41,0,2,0,43
2009,양천구,휘발유(유연),비사업용,2,0,0,0,2
2009,강서구,CNG,비사업용,7,5,17,0,29
2009,강서구,CNG,사업용,4,297,0,0,301
2009,강서구,경유,비사업용,24725,5343,15619,87,45774
2009,강서구,경유,사업용,1024,819,2109,89,4041
2009,강서구,기타연료,비사업용,10,5,50,4,69
2009,강서구,기타연료,사업용,0,0,19,0,19
2009,강서구,엘피지,비사업용,14818,4679,3644,3,23144
2009,강서구,엘피지,사업용,7901,4,476,0,8381
2009,강서구,하이브리드(LPG+전기),비사업용,52,0,0,0,52
2009,강서구,하이브리드(LPG+전기),사업용,1,0,0,0,1
2009,강서구,하이브리드(휘발유+전기),비사업용,45,0,0,0,45
2009,강서구,하이브리드(휘발유+전기),사업용,2,0,0,0,2
2009,강서구,휘발유,비사업용,31323,19,27,0,31369
2009,강서구,휘발유,사업용,2887,4,0,0,2891
2009,강서구,휘발유(무연),비사업용,58314,79,64,0,58457
2009,강서구,휘발유(무연),사업용,685,0,0,0,685
2009,강서구,휘발유(유연),비사업용,1,0,0,0,1
2009,구로구,CNG,비사업용,1,0,13,0,14
2009,구로구,CNG,사업용,0,234,0,0,234
2009,구로구,경유,비사업용,20272,4551,13689,33,38545
2009,구로구,경유,사업용,2732,655,1685,43,5115
2009,구로구,기타연료,비사업용,1,1,11,1,14
2009,구로구,기타연료,사업용,0,0,14,0,14
2009,구로구,엘피지,비사업용,9609,3160,2392,2,15163
2009,구로구,엘피지,사업용,7960,60,366,0,8386
2009,구로구,하이브리드(LPG+전기),비사업용,33,0,0,0,33
2009,구로구,하이브리드(LPG+전기),사업용,2,0,0,0,2
2009,구로구,하이브리드(휘발유+전기),비사업용,25,0,0,0,25
2009,구로구,하이브리드(휘발유+전기),사업용,1,0,0,0,1
2009,구로구,휘발유,비사업용,22321,12,31,0,22364
2009,구로구,휘발유,사업용,3852,0,0,0,3852
2009,구로구,휘발유(무연),비사업용,40235,50,49,0,40334
2009,구로구,휘발유(무연),사업용,1489,0,1,0,1490
2009,구로구,휘발유(유연),비사업용,3,0,0,0,3
2009,금천구,CNG,비사업용,3,1,10,0,14
2009,금천구,CNG,사업용,0,345,0,0,345
2009,금천구,경유,비사업용,11045,2910,9159,25,23139
2009,금천구,경유,사업용,18,69,1943,38,2068
2009,금천구,기타연료,비사업용,1,1,10,0,12
2009,금천구,기타연료,사업용,0,0,9,0,9
2009,금천구,엘피지,비사업용,5450,2068,1902,1,9421
2009,금천구,엘피지,사업용,2260,0,305,0,2565
2009,금천구,하이브리드(LPG+전기),비사업용,27,0,0,0,27
2009,금천구,하이브리드(휘발유+전기),비사업용,18,0,0,0,18
2009,금천구,휘발유,비사업용,12110,9,34,0,12153
2009,금천구,휘발유,사업용,7,0,0,0,7
2009,금천구,휘발유(무연),비사업용,21816,28,32,0,21876
2009,금천구,휘발유(무연),사업용,36,0,0,0,36
2009,금천구,휘발유(유연),비사업용,1,0,0,0,1
2009,영등포구,CNG,비사업용,17,2,31,0,50
2009,영등포구,CNG,사업용,1,77,0,0,78
2009,영등포구,경유,비사업용,23432,5002,17337,177,45948
2009,영등포구,경유,사업용,493,589,3292,449,4823
2009,영등포구,기타연료,비사업용,10,8,24,2,44
2009,영등포구,기타연료,사업용,0,0,138,3,141
2009,영등포구,엘피지,비사업용,9186,2867,2492,1,14546
2009,영등포구,엘피지,사업용,5899,15,423,5,6342
2009,영등포구,하이브리드(LPG+전기),비사업용,87,0,0,0,87
2009,영등포구,하이브리드(휘발유+전기),비사업용,79,0,0,0,79
2009,영등포구,휘발유,비사업용,29954,28,58,1,30041
2009,영등포구,휘발유,사업용,535,0,0,0,535
2009,영등포구,휘발유(무연),비사업용,43186,65,68,1,43320
2009,영등포구,휘발유(무연),사업용,117,1,0,0,118
2009,영등포구,휘발유(유연),비사업용,1,0,0,0,1
2009,동작구,CNG,비사업용,1,0,10,0,11
2009,동작구,CNG,사업용,0,41,0,0,41
2009,동작구,경유,비사업용,14689,2953,7539,25,25206
2009,동작구,경유,사업용,8,80,1099,37,1224
2009,동작구,기타연료,비사업용,6,2,15,1,24
2009,동작구,기타연료,사업용,0,0,4,0,4
2009,동작구,엘피지,비사업용,7869,2392,1627,2,11890
2009,동작구,엘피지,사업용,1483,0,247,0,1730
2009,동작구,하이브리드(LPG+전기),비사업용,36,0,0,0,36
2009,동작구,하이브리드(휘발유+전기),비사업용,35,0,0,0,35
2009,동작구,휘발유,비사업용,20265,15,16,0,20296
2009,동작구,휘발유,사업용,3,0,0,0,3
2009,동작구,휘발유(무연),비사업용,34996,42,30,0,35068
2009,동작구,휘발유(무연),사업용,1,0,0,0,1
2009,동작구,휘발유(유연),비사업용,3,1,0,0,4
2009,관악구,CNG,비사업용,0,0,18,0,18
2009,관악구,CNG,사업용,0,165,0,0,165
2009,관악구,경유,비사업용,18293,4196,10103,26,32618
2009,관악구,경유,사업용,199,145,1644,71,2059
2009,관악구,기타연료,비사업용,3,0,18,1,22
2009,관악구,기타연료,사업용,0,0,8,0,8
2009,관악구,엘피지,비사업용,10050,3301,2495,0,15846
2009,관악구,엘피지,사업용,2992,2,393,0,3387
2009,관악구,하이브리드(LPG+전기),비사업용,50,0,0,0,50
2009,관악구,하이브리드(LPG+전기),사업용,2,0,0,0,2
2009,관악구,하이브리드(휘발유+전기),비사업용,38,0,0,0,38
2009,관악구,휘발유,비사업용,22324,15,33,1,22373
2009,관악구,휘발유,사업용,184,0,0,0,184
2009,관악구,휘발유(무연),비사업용,42465,50,43,0,42558
2009,관악구,휘발유(무연),사업용,22,0,2,0,24
2009,서초구,CNG,비사업용,8,1,12,0,21
2009,서초구,CNG,사업용,10,359,0,0,369
2009,서초구,경유,비사업용,20720,3946,12435,102,37203
2009,서초구,경유,사업용,665,394,4343,126,5528
2009,서초구,기타연료,비사업용,10,9,67,3,89
2009,서초구,기타연료,사업용,0,0,130,3,133
2009,서초구,엘피지,비사업용,6645,2453,1711,0,10809
2009,서초구,엘피지,사업용,3006,12,219,0,3237
2009,서초구,하이브리드(LPG+전기),비사업용,94,0,0,0,94
2009,서초구,하이브리드(휘발유+전기),비사업용,161,0,0,0,161
2009,서초구,휘발유,비사업용,48239,51,63,0,48353
2009,서초구,휘발유,사업용,1717,1,0,0,1718
2009,서초구,휘발유(무연),비사업용,58836,110,56,1,59003
2009,서초구,휘발유(무연),사업용,344,0,0,0,344
2009,서초구,휘발유(유연),비사업용,5,0,0,0,5
2009,강남구,CNG,비사업용,14,11,15,0,40
2009,강남구,CNG,사업용,0,110,0,0,110
2009,강남구,LNG,비사업용,1,0,0,0,1
2009,강남구,경유,비사업용,30052,5370,15071,72,50565
2009,강남구,경유,사업용,1223,806,1248,128,3405
2009,강남구,기타연료,비사업용,25,3,48,21,97
2009,강남구,기타연료,사업용,0,11,250,1,262
2009,강남구,엘피지,비사업용,9197,3374,2368,4,14943
2009,강남구,엘피지,사업용,5726,16,137,0,5879
2009,강남구,하이브리드(LPG+전기),비사업용,77,0,0,0,77
2009,강남구,하이브리드(LPG+전기),사업용,12,0,0,0,12
2009,강남구,하이브리드(휘발유+전기),비사업용,577,0,0,0,577
2009,강남구,휘발유,비사업용,81244,62,122,0,81428
2009,강남구,휘발유,사업용,3344,2,0,0,3346
2009,강남구,휘발유(무연),비사업용,82809,157,110,1,83077
2009,강남구,휘발유(무연),사업용,1210,0,0,0,1210
2009,강남구,휘발유(유연),비사업용,2,0,0,0,2
2009,송파구,CNG,비사업용,18,1,47,0,66
2009,송파구,CNG,사업용,27,794,0,0,821
2009,송파구,경유,비사업용,31103,5757,18359,55,55274
2009,송파구,경유,사업용,86,579,3005,111,3781
2009,송파구,기타연료,비사업용,6,7,56,3,72
2009,송파구,기타연료,사업용,0,0,51,0,51
2009,송파구,엘피지,비사업용,13359,4463,3711,1,21534
2009,송파구,엘피지,사업용,4584,1,540,0,5125
2009,송파구,하이브리드(LPG+전기),비사업용,96,0,0,0,96
2009,송파구,하이브리드(휘발유+전기),비사업용,70,0,0,0,70
2009,송파구,휘발유,비사업용,50296,22,68,0,50386
2009,송파구,휘발유,사업용,216,2,0,0,218
2009,송파구,휘발유(무연),비사업용,73759,91,59,0,73909
2009,송파구,휘발유(무연),사업용,52,0,1,0,53
2009,송파구,휘발유(유연),비사업용,4,0,0,0,4
2009,강동구,CNG,비사업용,4,0,15,0,19
2009,강동구,CNG,사업용,27,190,0,0,217
2009,강동구,경유,비사업용,20859,4270,12502,27,37658
2009,강동구,경유,사업용,230,471,1645,120,2466
2009,강동구,기타연료,비사업용,7,3,22,2,34
2009,강동구,기타연료,사업용,0,0,33,0,33
2009,강동구,엘피지,비사업용,11450,3851,3005,0,18306
2009,강동구,엘피지,사업용,4970,5,468,1,5444
2009,강동구,하이브리드(LPG+전기),비사업용,61,0,0,0,61
2009,강동구,하이브리드(LPG+전기),사업용,2,0,0,0,2
2009,강동구,하이브리드(휘발유+전기),비사업용,29,0,0,0,29
2009,강동구,휘발유,비사업용,25988,21,47,0,26056
2009,강동구,휘발유,사업용,793,0,0,0,793
2009,강동구,휘발유(무연),비사업용,45630,69,56,0,45755
2009,강동구,휘발유(무연),사업용,160,0,0,0,160
2009,강동구,휘발유(유연),비사업용,4,0,0,0,4
2010,합계,계,계,2434230,176999,366306,3865,2981400
2010,종로구,CNG,비사업용,3,3,17,0,23
2010,종로구,CNG,사업용,0,93,0,0,93
2010,종로구,경유,비사업용,7371,2654,5230,70,15325
2010,종로구,경유,사업용,60,360,448,18,886
2010,종로구,기타연료,비사업용,7,3,17,3,30
2010,종로구,기타연료,사업용,0,0,65,0,65
2010,종로구,엘피지,비사업용,2644,996,716,2,4358
2010,종로구,엘피지,사업용,398,4,168,0,570
2010,종로구,하이브리드(LPG+전기),비사업용,58,0,0,0,58
2010,종로구,하이브리드(휘발유+전기),비사업용,103,0,0,0,103
2010,종로구,휘발유,비사업용,12418,25,45,0,12488
2010,종로구,휘발유,사업용,181,0,0,0,181
2010,종로구,휘발유(무연),비사업용,15366,52,22,1,15441
2010,종로구,휘발유(무연),사업용,47,0,0,0,47
2010,종로구,휘발유(유연),비사업용,1,0,0,0,1
2010,중구,CNG,비사업용,1,5,16,0,22
2010,중구,CNG,사업용,0,6,0,0,6
2010,중구,경유,비사업용,8493,2739,5707,60,16999
2010,중구,경유,사업용,676,310,1586,82,2654
2010,중구,기타연료,비사업용,4,3,28,15,50
2010,중구,기타연료,사업용,0,0,60,0,60
2010,중구,엘피지,비사업용,2235,946,799,2,3982
2010,중구,엘피지,사업용,996,9,148,0,1153
2010,중구,전기,비사업용,8,0,0,0,8
2010,중구,하이브리드(LPG+전기),비사업용,35,0,0,0,35
2010,중구,하이브리드(휘발유+전기),비사업용,127,0,0,0,127
2010,중구,휘발유,비사업용,17945,25,30,0,18000
2010,중구,휘발유,사업용,1148,3,0,0,1151
2010,중구,휘발유(무연),비사업용,17383,43,32,0,17458
2010,중구,휘발유(무연),사업용,788,0,1,0,789
2010,중구,휘발유(유연),비사업용,1,0,0,0,1
2010,용산구,CNG,비사업용,4,12,29,0,45
2010,용산구,CNG,사업용,0,1,0,0,1
2010,용산구,경유,비사업용,10196,2353,5916,21,18486
2010,용산구,경유,사업용,8,77,814,48,947
2010,용산구,기타연료,비사업용,1769,8,25,1,1803
2010,용산구,기타연료,사업용,0,0,40,0,40
2010,용산구,엘피지,비사업용,4013,1347,1055,0,6415
2010,용산구,엘피지,사업용,766,0,142,0,908
2010,용산구,하이브리드(LPG+전기),비사업용,69,0,0,0,69
2010,용산구,하이브리드(휘발유+전기),비사업용,79,0,0,0,79
2010,용산구,휘발유,비사업용,21003,19,56,0,21078
2010,용산구,휘발유,사업용,32,0,0,0,32
2010,용산구,휘발유(무연),비사업용,25560,64,40,0,25664
2010,용산구,휘발유(무연),사업용,11,0,0,0,11
2010,용산구,휘발유(유연),비사업용,1,0,0,0,1
2010,성동구,CNG,비사업용,9,3,15,0,27
2010,성동구,CNG,사업용,0,202,0,0,202
2010,성동구,경유,비사업용,13533,2636,8287,27,24483
2010,성동구,경유,사업용,50,121,1242,81,1494
2010,성동구,기타연료,비사업용,2,3,19,1,25
2010,성동구,기타연료,사업용,0,0,5,0,5
2010,성동구,엘피지,비사업용,7540,1746,1797,1,11084
2010,성동구,엘피지,사업용,2433,0,350,0,2783
2010,성동구,전기,비사업용,11,0,0,0,11
2010,성동구,하이브리드(LPG+전기),비사업용,56,0,0,0,56
2010,성동구,하이브리드(휘발유+전기),비사업용,75,0,0,0,75
2010,성동구,휘발유,비사업용,19159,3,13,0,19175
2010,성동구,휘발유,사업용,234,0,0,0,234
2010,성동구,휘발유(무연),비사업용,27496,35,16,0,27547
2010,성동구,휘발유(무연),사업용,75,0,0,0,75
2010,성동구,휘발유(유연),비사업용,1,0,0,0,1
2010,광진구,CNG,비사업용,5,2,11,0,18
2010,광진구,CNG,사업용,1,9,0,0,10
2010,광진구,경유,비사업용,14431,3128,8845,25,26429
2010,광진구,경유,사업용,32,333,1042,40,1447
2010,광진구,기타연료,비사업용,4,2,15,1,22
2010,광진구,엘피지,비사업용,6898,2175,1923,0,10996
2010,광진구,엘피지,사업용,2567,1,299,0,2867
2010,광진구,하이브리드(LPG+전기),비사업용,67,0,0,0,67
2010,광진구,하이브리드(LPG+전기),사업용,1,0,0,0,1
2010,광진구,하이브리드(휘발유+전기),비사업용,58,0,0,0,58
2010,광진구,휘발유,비사업용,20214,11,25,0,20250
2010,광진구,휘발유,사업용,108,0,0,0,108
2010,광진구,휘발유(무연),비사업용,30336,48,35,0,30419
2010,광진구,휘발유(무연),사업용,19,0,0,0,19
2010,광진구,휘발유(유연),비사업용,1,0,0,0,1
2010,동대문구,CNG,비사업용,3,2,21,0,26
2010,동대문구,CNG,사업용,1,11,0,0,12
2010,동대문구,경유,비사업용,14619,3445,9766,38,27868
2010,동대문구,경유,사업용,71,216,1758,53,2098
2010,동대문구,기타연료,비사업용,3,2,19,2,26
2010,동대문구,기타연료,사업용,0,0,4,0,4
2010,동대문구,엘피지,비사업용,7313,2098,2201,0,11612
2010,동대문구,엘피지,사업용,2796,3,482,0,3281
2010,동대문구,하이브리드(LPG+전기),비사업용,58,0,0,0,58
2010,동대문구,하이브리드(휘발유+전기),비사업용,52,0,0,0,52
2010,동대문구,휘발유,비사업용,18007,14,30,0,18051
2010,동대문구,휘발유,사업용,62,0,0,0,62
2010,동대문구,휘발유(무연),비사업용,27625,45,30,0,27700
2010,동대문구,휘발유(무연),사업용,100,0,1,0,101
2010,동대문구,휘발유(유연),비사업용,3,0,0,0,3
2010,중랑구,CNG,비사업용,5,3,21,0,29
2010,중랑구,CNG,사업용,1,732,0,0,733
2010,중랑구,경유,비사업용,15821,3838,10863,29,30551
2010,중랑구,경유,사업용,38,225,2041,152,2456
2010,중랑구,기타연료,비사업용,2,7,13,1,23
2010,중랑구,기타연료,사업용,0,1,5,0,6
2010,중랑구,엘피지,비사업용,9275,2962,2843,0,15080
2010,중랑구,엘피지,사업용,5456,0,554,6,6016
2010,중랑구,전기,사업용,0,5,0,0,5
2010,중랑구,하이브리드(LPG+전기),비사업용,51,0,0,0,51
2010,중랑구,하이브리드(휘발유+전기),비사업용,36,0,0,0,36
2010,중랑구,휘발유,비사업용,17456,15,23,0,17494
2010,중랑구,휘발유,사업용,32,0,0,0,32
2010,중랑구,휘발유(무연),비사업용,31153,61,33,0,31247
2010,중랑구,휘발유(무연),사업용,18,0,1,0,19
2010,중랑구,휘발유(유연),비사업용,1,0,0,0,1
2010,성북구,CNG,비사업용,1,2,6,0,9
2010,성북구,CNG,사업용,1,765,0,0,766
2010,성북구,경유,비사업용,19454,4133,8965,25,32577
2010,성북구,경유,사업용,17,195,1288,27,1527
2010,성북구,기타연료,비사업용,4,8,35,2,49
2010,성북구,엘피지,비사업용,9451,2810,2172,2,14435
2010,성북구,엘피지,사업용,2727,2,452,0,3181
2010,성북구,하이브리드(LPG+전기),비사업용,59,0,0,0,59
2010,성북구,하이브리드(휘발유+전기),비사업용,57,0,0,0,57
2010,성북구,휘발유,비사업용,24270,14,35,0,24319
2010,성북구,휘발유,사업용,21,0,0,0,21
2010,성북구,휘발유(무연),비사업용,38517,49,32,0,38598
2010,성북구,휘발유(무연),사업용,1,0,0,0,1
2010,성북구,휘발유(유연),비사업용,1,0,0,0,1
2010,강북구,CNG,비사업용,2,1,14,0,17
2010,강북구,CNG,사업용,1,635,0,0,636
2010,강북구,경유,비사업용,11427,2852,6816,25,21120
2010,강북구,경유,사업용,9,89,975,17,1090
2010,강북구,기타연료,비사업용,2,2,7,0,11
2010,강북구,기타연료,사업용,0,4,0,0,4
2010,강북구,엘피지,비사업용,7068,2331,1885,1,11285
2010,강북구,엘피지,사업용,2550,0,447,0,2997
2010,강북구,전기,비사업용,1,0,0,0,1
2010,강북구,하이브리드(LPG+전기),비사업용,44,0,0,0,44
2010,강북구,하이브리드(휘발유+전기),비사업용,34,0,0,0,34
2010,강북구,휘발유,비사업용,12605,12,22,0,12639
2010,강북구,휘발유,사업용,10,0,0,0,10
2010,강북구,휘발유(무연),비사업용,23846,42,13,0,23901
2010,강북구,휘발유(무연),사업용,15,0,0,0,15
2010,강북구,휘발유(유연),비사업용,1,0,0,0,1
2010,도봉구,CNG,비사업용,3,2,8,0,13
2010,도봉구,CNG,사업용,50,348,0,0,398
2010,도봉구,경유,비사업용,14480,3070,7844,19,25413
2010,도봉구,경유,사업용,28,163,911,63,1165
2010,도봉구,기타연료,비사업용,3,5,16,1,25
2010,도봉구,기타연료,사업용,0,0,6,0,6
2010,도봉구,엘피지,비사업용,8142,2550,2088,0,12780
2010,도봉구,엘피지,사업용,5469,3,288,0,5760
2010,도봉구,전기,비사업용,1,0,0,0,1
2010,도봉구,하이브리드(LPG+전기),비사업용,55,0,0,0,55
2010,도봉구,하이브리드(휘발유+전기),비사업용,52,0,0,0,52
2010,도봉구,휘발유,비사업용,16834,7,18,0,16859
2010,도봉구,휘발유,사업용,42,0,0,0,42
2010,도봉구,휘발유(무연),비사업용,31068,39,23,0,31130
2010,도봉구,휘발유(무연),사업용,17,0,0,0,17
2010,도봉구,휘발유(유연),비사업용,3,0,0,0,3
2010,노원구,CNG,비사업용,11,3,9,0,23
2010,노원구,CNG,사업용,1,597,0,0,598
2010,노원구,경유,비사업용,25278,4884,10774,30,40966
2010,노원구,경유,사업용,66,190,1366,72,1694
2010,노원구,기타연료,비사업용,4,10,29,1,44
2010,노원구,기타연료,사업용,0,0,11,0,11
2010,노원구,엘피지,비사업용,14589,3702,2654,0,20945
2010,노원구,엘피지,사업용,6749,3,460,0,7212
2010,노원구,하이브리드(LPG+전기),비사업용,89,0,0,0,89
2010,노원구,하이브리드(휘발유+전기),비사업용,67,0,0,0,67
2010,노원구,휘발유,비사업용,30283,11,36,0,30330
2010,노원구,휘발유,사업용,82,0,0,0,82
2010,노원구,휘발유(무연),비사업용,53540,68,37,0,53645
2010,노원구,휘발유(무연),사업용,33,0,2,0,35
2010,노원구,휘발유(유연),비사업용,3,0,0,0,3
2010,은평구,CNG,비사업용,5,2,18,0,25
2010,은평구,CNG,사업용,0,586,0,0,586
2010,은평구,경유,비사업용,17999,4233,10290,28,32550
2010,은평구,경유,사업용,14,104,1255,51,1424
2010,은평구,기타연료,비사업용,3,2,18,1,24
2010,은평구,기타연료,사업용,0,0,2,0,2
2010,은평구,등유,비사업용,0,1,0,0,1
2010,은평구,엘피지,비사업용,10056,2986,2386,1,15429
2010,은평구,엘피지,사업용,3722,1,395,0,4118
2010,은평구,태양열,비사업용,1,0,0,0,1
2010,은평구,하이브리드(LPG+전기),비사업용,88,0,0,0,88
2010,은평구,하이브리드(휘발유+전기),비사업용,62,0,0,0,62
2010,은평구,휘발유,비사업용,22456,19,29,0,22504
2010,은평구,휘발유,사업용,17,0,0,0,17
2010,은평구,휘발유(무연),비사업용,39053,67,42,0,39162
2010,은평구,휘발유(무연),사업용,6,0,0,0,6
2010,은평구,휘발유(유연),비사업용,2,0,0,0,2
2010,서대문구,CNG,비사업용,2,2,14,0,18
2010,서대문구,CNG,사업용,1,288,0,0,289
2010,서대문구,경유,비사업용,12218,2836,6424,28,21506
2010,서대문구,경유,사업용,4,111,1278,54,1447
2010,서대문구,기타연료,비사업용,3,1,9,0,13
2010,서대문구,기타연료,사업용,0,8,16,0,24
2010,서대문구,엘피지,비사업용,6150,1771,1380,0,9301
2010,서대문구,엘피지,사업용,2570,0,232,0,2802
2010,서대문구,하이브리드(LPG+전기),비사업용,55,0,0,0,55
2010,서대문구,하이브리드(휘발유+전기),비사업용,64,0,0,0,64
2010,서대문구,휘발유,비사업용,16787,15,34,0,16836
2010,서대문구,휘발유,사업용,15,0,0,0,15
2010,서대문구,휘발유(무연),비사업용,27091,46,22,0,27159
2010,서대문구,휘발유(무연),사업용,11,0,0,0,11
2010,서대문구,휘발유(유연),비사업용,2,0,0,0,2
2010,마포구,CNG,비사업용,7,3,12,0,22
2010,마포구,CNG,사업용,1,285,0,0,286
2010,마포구,경유,비사업용,17311,3528,9601,71,30511
2010,마포구,경유,사업용,112,329,2149,143,2733
2010,마포구,기타연료,비사업용,4,17,25,2,48
2010,마포구,기타연료,사업용,0,0,48,0,48
2010,마포구,엘피지,비사업용,7563,2206,1901,1,11671
2010,마포구,엘피지,사업용,2735,1,252,0,2988
2010,마포구,하이브리드(LPG+전기),비사업용,54,0,0,0,54
2010,마포구,하이브리드(휘발유+전기),비사업용,70,0,0,0,70
2010,마포구,휘발유,비사업용,25192,21,44,0,25257
2010,마포구,휘발유,사업용,254,0,0,0,254
2010,마포구,휘발유(무연),비사업용,35978,52,48,0,36078
2010,마포구,휘발유(무연),사업용,103,0,0,0,103
2010,마포구,휘발유(유연),비사업용,1,0,0,0,1
2010,양천구,CNG,비사업용,6,0,9,0,15
2010,양천구,CNG,사업용,3,668,0,0,671
2010,양천구,경유,비사업용,21741,4218,12303,84,38346
2010,양천구,경유,사업용,24,231,2150,296,2701
2010,양천구,기타연료,비사업용,4,8,24,2,38
2010,양천구,기타연료,사업용,0,0,108,0,108
2010,양천구,엘피지,비사업용,11425,3310,2797,0,17532
2010,양천구,엘피지,사업용,5035,6,392,0,5433
2010,양천구,하이브리드(LPG+전기),비사업용,79,0,0,0,79
2010,양천구,하이브리드(휘발유+전기),비사업용,58,0,0,0,58
2010,양천구,휘발유,비사업용,31970,17,22,0,32009
2010,양천구,휘발유,사업용,203,0,0,0,203
2010,양천구,휘발유(무연),비사업용,49149,58,44,0,49251
2010,양천구,휘발유(무연),사업용,24,0,1,0,25
2010,양천구,휘발유(유연),비사업용,1,0,0,0,1
2010,강서구,CNG,비사업용,16,5,18,0,39
2010,강서구,CNG,사업용,10,359,0,0,369
2010,강서구,경유,비사업용,25762,5379,15230,91,46462
2010,강서구,경유,사업용,1609,963,2168,93,4833
2010,강서구,기타연료,비사업용,5,7,67,4,83
2010,강서구,기타연료,사업용,0,0,18,0,18
2010,강서구,엘피지,비사업용,15222,4353,3587,2,23164
2010,강서구,엘피지,사업용,8361,5,470,0,8836
2010,강서구,하이브리드(LPG+전기),비사업용,96,0,0,0,96
2010,강서구,하이브리드(LPG+전기),사업용,3,0,0,0,3
2010,강서구,하이브리드(휘발유+전기),비사업용,68,0,0,0,68
2010,강서구,하이브리드(휘발유+전기),사업용,2,0,0,0,2
2010,강서구,휘발유,비사업용,35041,17,31,0,35089
2010,강서구,휘발유,사업용,3227,4,0,0,3231
2010,강서구,휘발유(무연),비사업용,56484,72,57,0,56613
2010,강서구,휘발유(무연),사업용,2091,1,0,0,2092
2010,구로구,CNG,비사업용,3,0,13,0,16
2010,구로구,CNG,사업용,5,326,0,0,331
2010,구로구,경유,비사업용,20728,4339,13479,35,38581
2010,구로구,경유,사업용,2737,935,1800,42,5514
2010,구로구,기타연료,비사업용,3,8,18,1,30
2010,구로구,기타연료,사업용,0,0,17,0,17
2010,구로구,엘피지,비사업용,9906,2747,2396,3,15052
2010,구로구,엘피지,사업용,8607,66,367,0,9040
2010,구로구,하이브리드(LPG+전기),비사업용,60,0,0,0,60
2010,구로구,하이브리드(LPG+전기),사업용,41,0,0,0,41
2010,구로구,하이브리드(휘발유+전기),비사업용,38,0,0,0,38
2010,구로구,휘발유,비사업용,24460,13,30,0,24503
2010,구로구,휘발유,사업용,3599,0,0,0,3599
2010,구로구,휘발유(무연),비사업용,39198,38,40,0,39276
2010,구로구,휘발유(무연),사업용,2348,0,1,0,2349
2010,구로구,휘발유(유연),비사업용,3,0,0,0,3
2010,금천구,CNG,비사업용,5,1,11,0,17
2010,금천구,CNG,사업용,1,385,0,0,386
2010,금천구,경유,비사업용,11254,2896,9143,29,23322
2010,금천구,경유,사업용,15,47,1994,39,2095
2010,금천구,기타연료,비사업용,1,1,11,0,13
2010,금천구,기타연료,사업용,0,0,8,0,8
2010,금천구,엘피지,비사업용,5563,1917,1904,1,9385
2010,금천구,엘피지,사업용,2127,0,267,0,2394
2010,금천구,전기,비사업용,7,0,0,0,7
2010,금천구,하이브리드(LPG+전기),비사업용,47,0,0,0,47
2010,금천구,하이브리드(휘발유+전기),비사업용,28,0,0,0,28
2010,금천구,휘발유,비사업용,13249,8,34,0,13291
2010,금천구,휘발유,사업용,4,0,0,0,4
2010,금천구,휘발유(무연),비사업용,21486,23,32,0,21541
2010,금천구,휘발유(무연),사업용,18,0,0,0,18
2010,금천구,휘발유(유연),비사업용,3,0,0,0,3
2010,영등포구,CNG,비사업용,16,2,32,0,50
2010,영등포구,CNG,사업용,1,55,0,0,56
2010,영등포구,경유,비사업용,22500,4838,17264,187,44789
2010,영등포구,경유,사업용,306,519,3853,454,5132
2010,영등포구,기타연료,비사업용,8,10,39,2,59
2010,영등포구,기타연료,사업용,0,0,142,4,146
2010,영등포구,엘피지,비사업용,9107,2626,2473,0,14206
2010,영등포구,엘피지,사업용,4572,7,424,6,5009
2010,영등포구,전기,비사업용,2,0,0,0,2
2010,영등포구,하이브리드(LPG+전기),비사업용,139,0,0,0,139
2010,영등포구,하이브리드(휘발유+전기),비사업용,100,0,0,0,100
2010,영등포구,휘발유,비사업용,31023,33,56,1,31113
2010,영등포구,휘발유,사업용,346,0,0,0,346
2010,영등포구,휘발유(무연),비사업용,41663,57,60,1,41781
2010,영등포구,휘발유(무연),사업용,96,0,0,0,96
2010,영등포구,휘발유(유연),비사업용,1,0,0,0,1
2010,동작구,CNG,비사업용,4,0,11,0,15
2010,동작구,CNG,사업용,0,50,0,0,50
2010,동작구,경유,비사업용,15274,2883,7308,28,25493
2010,동작구,경유,사업용,17,124,1097,47,1285
2010,동작구,기타연료,비사업용,4,3,23,1,31
2010,동작구,기타연료,사업용,0,0,7,0,7
2010,동작구,엘피지,비사업용,7984,2090,1625,1,11700
2010,동작구,엘피지,사업용,1529,0,239,0,1768
2010,동작구,하이브리드(LPG+전기),비사업용,62,0,0,0,62
2010,동작구,하이브리드(휘발유+전기),비사업용,69,0,0,0,69
2010,동작구,휘발유,비사업용,22229,16,16,0,22261
2010,동작구,휘발유,사업용,7,0,0,0,7
2010,동작구,휘발유(무연),비사업용,33762,41,23,0,33826
2010,동작구,휘발유(무연),사업용,3,0,0,0,3
2010,동작구,휘발유(유연),비사업용,1,1,0,0,2
2010,관악구,CNG,비사업용,3,0,20,0,23
2010,관악구,CNG,사업용,1,205,0,0,206
2010,관악구,경유,비사업용,18719,4074,9785,22,32600
2010,관악구,경유,사업용,219,114,1584,89,2006
2010,관악구,기타연료,비사업용,3,3,24,1,31
2010,관악구,기타연료,사업용,0,0,12,0,12
2010,관악구,엘피지,비사업용,10137,2981,2418,0,15536
2010,관악구,엘피지,사업용,3025,2,387,0,3414
2010,관악구,하이브리드(LPG+전기),비사업용,87,0,0,0,87
2010,관악구,하이브리드(휘발유+전기),비사업용,65,0,0,0,65
2010,관악구,휘발유,비사업용,24071,15,36,1,24123
2010,관악구,휘발유,사업용,200,0,0,0,200
2010,관악구,휘발유(무연),비사업용,40772,43,35,0,40850
2010,관악구,휘발유(무연),사업용,39,0,2,0,41
2010,서초구,CNG,비사업용,9,1,22,0,32
2010,서초구,CNG,사업용,9,383,0,0,392
2010,서초구,경유,비사업용,21748,4063,11754,111,37676
2010,서초구,경유,사업용,698,363,4406,100,5567
2010,서초구,기타연료,비사업용,9,12,81,2,104
2010,서초구,기타연료,사업용,0,0,101,3,104
2010,서초구,엘피지,비사업용,6567,2200,1724,0,10491
2010,서초구,엘피지,사업용,2850,15,183,0,3048
2010,서초구,전기,비사업용,3,0,0,0,3
2010,서초구,하이브리드(LPG+전기),비사업용,147,0,0,0,147
2010,서초구,하이브리드(휘발유+전기),비사업용,250,0,0,0,250
2010,서초구,휘발유,비사업용,52720,50,61,0,52831
2010,서초구,휘발유,사업용,1812,1,0,0,1813
2010,서초구,휘발유(무연),비사업용,56604,94,55,1,56754
2010,서초구,휘발유(무연),사업용,785,0,0,0,785
2010,서초구,휘발유(유연),비사업용,4,0,0,0,4
2010,강남구,CNG,비사업용,19,11,20,0,50
2010,강남구,CNG,사업용,4,180,0,0,184
2010,강남구,LNG,비사업용,1,0,0,0,1
2010,강남구,경유,비사업용,29833,5214,14846,89,49982
2010,강남구,경유,사업용,5069,1521,1238,126,7954
2010,강남구,기타연료,비사업용,23,9,69,19,120
2010,강남구,기타연료,사업용,0,11,251,1,263
2010,강남구,엘피지,비사업용,9197,2968,2391,1,14557
2010,강남구,엘피지,사업용,12000,49,124,0,12173
2010,강남구,전기,비사업용,13,0,0,0,13
2010,강남구,하이브리드(LPG+전기),비사업용,117,0,0,0,117
2010,강남구,하이브리드(LPG+전기),사업용,310,0,0,0,310
2010,강남구,하이브리드(휘발유+전기),비사업용,580,0,0,0,580
2010,강남구,하이브리드(휘발유+전기),사업용,7,0,0,0,7
2010,강남구,휘발유,비사업용,76786,65,114,1,76966
2010,강남구,휘발유,사업용,9244,4,0,0,9248
2010,강남구,휘발유(무연),비사업용,75753,128,107,1,75989
2010,강남구,휘발유(무연),사업용,5578,1,0,0,5579
2010,강남구,휘발유(유연),비사업용,5,0,0,0,5
2010,송파구,CNG,비사업용,18,1,49,0,68
2010,송파구,CNG,사업용,82,840,0,0,922
2010,송파구,경유,비사업용,32040,5614,17999,54,55707
2010,송파구,경유,사업용,114,565,2988,140,3807
2010,송파구,기타연료,비사업용,4,11,54,4,73
2010,송파구,기타연료,사업용,0,0,54,0,54
2010,송파구,엘피지,비사업용,13293,3979,3678,0,20950
2010,송파구,엘피지,사업용,4837,5,529,0,5371
2010,송파구,전기,비사업용,1,0,0,0,1
2010,송파구,하이브리드(LPG+전기),비사업용,142,0,0,0,142
2010,송파구,하이브리드(휘발유+전기),비사업용,126,0,0,0,126
2010,송파구,휘발유,비사업용,54500,23,73,0,54596
2010,송파구,휘발유,사업용,253,2,0,0,255
2010,송파구,휘발유(무연),비사업용,71206,79,48,0,71333
2010,송파구,휘발유(무연),사업용,80,0,1,0,81
2010,송파구,휘발유(유연),비사업용,4,0,0,0,4
2010,강동구,CNG,비사업용,8,0,17,0,25
2010,강동구,CNG,사업용,86,193,0,0,279
2010,강동구,경유,비사업용,21740,4206,12378,39,38363
2010,강동구,경유,사업용,229,503,1615,156,2503
2010,강동구,기타연료,비사업용,7,7,24,2,40
2010,강동구,기타연료,사업용,0,0,32,0,32
2010,강동구,엘피지,비사업용,11533,3890,3058,2,18483
2010,강동구,엘피지,사업용,4968,5,442,1,5416
2010,강동구,하이브리드(LPG+전기),비사업용,89,0,0,0,89
2010,강동구,하이브리드(LPG+전기),사업용,1,0,0,0,1
2010,강동구,하이브리드(휘발유+전기),비사업용,58,0,0,0,58
2010,강동구,휘발유,비사업용,28442,22,41,0,28505
2010,강동구,휘발유,사업용,674,0,0,0,674
2010,강동구,휘발유(무연),비사업용,44679,63,55,0,44797
2010,강동구,휘발유(무연),사업용,269,0,0,0,269
2010,강동구,휘발유(유연),비사업용,2,0,0,0,2
2011,합계,계,계,2443261,169922,360103,4313,2977599
2011,종로구,CNG,비사업용,6,2,17,0,25
2011,종로구,CNG,사업용,0,94,0,0,94
2011,종로구,경유,비사업용,7775,3292,5315,87,16469
2011,종로구,경유,사업용,53,342,431,22,848
2011,종로구,기타연료,비사업용,4,5,19,3,31
2011,종로구,기타연료,사업용,0,0,73,0,73
2011,종로구,엘피지,비사업용,2672,893,655,0,4220
2011,종로구,엘피지,사업용,376,4,168,0,548
2011,종로구,전기,비사업용,2,0,0,0,2
2011,종로구,하이브리드(LPG+전기),비사업용,58,0,0,0,58
2011,종로구,하이브리드(휘발유+전기),비사업용,255,0,0,0,255
2011,종로구,휘발유,비사업용,13482,24,48,0,13554
2011,종로구,휘발유,사업용,187,0,0,0,187
2011,종로구,휘발유(무연),비사업용,15527,52,20,1,15600
2011,종로구,휘발유(무연),사업용,81,0,0,0,81
2011,종로구,휘발유(유연),비사업용,2,0,0,0,2
2011,중구,CNG,비사업용,2,3,17,0,22
2011,중구,CNG,사업용,3,6,0,0,9
2011,중구,경유,비사업용,9079,2773,5538,86,17476
2011,중구,경유,사업용,760,398,1526,102,2786
2011,중구,기타연료,비사업용,4,4,36,14,58
2011,중구,기타연료,사업용,0,0,65,0,65
2011,중구,엘피지,비사업용,2224,848,725,1,3798
2011,중구,엘피지,사업용,1334,5,125,0,1464
2011,중구,전기,비사업용,13,0,0,0,13
2011,중구,하이브리드(LPG+전기),비사업용,46,0,0,0,46
2011,중구,하이브리드(LPG+전기),사업용,16,0,0,0,16
2011,중구,하이브리드(휘발유+전기),비사업용,183,0,0,0,183
2011,중구,하이브리드(휘발유+전기),사업용,3,0,0,0,3
2011,중구,휘발유,비사업용,17896,34,23,0,17953
2011,중구,휘발유,사업용,1035,3,0,0,1038
2011,중구,휘발유(무연),비사업용,15096,37,32,0,15165
2011,중구,휘발유(무연),사업용,1281,1,0,0,1282
2011,중구,휘발유(유연),비사업용,1,0,0,0,1
2011,용산구,CNG,비사업용,7,12,29,0,48
2011,용산구,CNG,사업용,1,10,0,0,11
2011,용산구,경유,비사업용,10855,2369,5775,22,19021
2011,용산구,경유,사업용,19,78,942,50,1089
2011,용산구,기타연료,비사업용,1273,9,25,1,1308
2011,용산구,기타연료,사업용,0,0,42,0,42
2011,용산구,엘피지,비사업용,4056,1242,959,0,6257
2011,용산구,엘피지,사업용,853,0,130,0,983
2011,용산구,전기,비사업용,1,0,0,0,1
2011,용산구,하이브리드(LPG+전기),비사업용,87,0,0,0,87
2011,용산구,하이브리드(LPG+전기),사업용,1,0,0,0,1
2011,용산구,하이브리드(휘발유+전기),비사업용,220,0,0,0,220
2011,용산구,휘발유,비사업용,22119,20,54,0,22193
2011,용산구,휘발유,사업용,49,0,0,0,49
2011,용산구,휘발유(무연),비사업용,25280,62,34,0,25376
2011,용산구,휘발유(무연),사업용,26,0,0,0,26
2011,용산구,휘발유(유연),비사업용,2,0,0,0,2
2011,성동구,CNG,비사업용,19,3,17,0,39
2011,성동구,CNG,사업용,2,202,0,0,204
2011,성동구,경유,비사업용,13885,2671,8383,33,24972
2011,성동구,경유,사업용,84,151,1243,83,1561
2011,성동구,기타연료,비사업용,2,6,30,1,39
2011,성동구,기타연료,사업용,0,0,5,0,5
2011,성동구,엘피지,비사업용,7155,1526,1534,0,10215
2011,성동구,엘피지,사업용,2535,2,340,0,2877
2011,성동구,전기,비사업용,14,0,0,0,14
2011,성동구,하이브리드(LPG+전기),비사업용,83,0,0,0,83
2011,성동구,하이브리드(휘발유+전기),비사업용,168,0,0,0,168
2011,성동구,하이브리드(휘발유+전기),사업용,3,0,0,0,3
2011,성동구,휘발유,비사업용,19953,1,17,0,19971
2011,성동구,휘발유,사업용,201,0,0,0,201
2011,성동구,휘발유(무연),비사업용,26679,25,10,0,26714
2011,성동구,휘발유(무연),사업용,151,0,0,0,151
2011,광진구,CNG,비사업용,8,2,11,0,21
2011,광진구,CNG,사업용,2,350,0,0,352
2011,광진구,경유,비사업용,15106,3141,8821,26,27094
2011,광진구,경유,사업용,47,406,1262,131,1846
2011,광진구,기타연료,비사업용,2,5,17,0,24
2011,광진구,기타연료,사업용,0,0,1,0,1
2011,광진구,엘피지,비사업용,6758,1940,1740,1,10439
2011,광진구,엘피지,사업용,2792,3,277,0,3072
2011,광진구,전기,비사업용,2,0,0,0,2
2011,광진구,하이브리드(LPG+전기),비사업용,73,0,0,0,73
2011,광진구,하이브리드(휘발유+전기),비사업용,154,0,0,0,154
2011,광진구,휘발유,비사업용,21097,9,20,0,21126
2011,광진구,휘발유,사업용,117,0,0,0,117
2011,광진구,휘발유(무연),비사업용,29905,43,37,0,29985
2011,광진구,휘발유(무연),사업용,34,0,0,0,34
2011,동대문구,CNG,비사업용,3,2,22,0,27
2011,동대문구,CNG,사업용,4,14,0,0,18
2011,동대문구,경유,비사업용,15199,3443,9888,37,28567
2011,동대문구,경유,사업용,64,238,1757,68,2127
2011,동대문구,기타연료,비사업용,3,5,25,1,34
2011,동대문구,기타연료,사업용,0,0,4,0,4
2011,동대문구,엘피지,비사업용,7301,1906,2010,2,11219
2011,동대문구,엘피지,사업용,2561,1,457,0,3019
2011,동대문구,전기,비사업용,1,0,0,0,1
2011,동대문구,하이브리드(LPG+전기),비사업용,69,0,0,0,69
2011,동대문구,하이브리드(휘발유+전기),비사업용,118,0,0,0,118
2011,동대문구,휘발유,비사업용,18826,12,32,0,18870
2011,동대문구,휘발유,사업용,61,0,0,0,61
2011,동대문구,휘발유(무연),비사업용,27401,39,29,0,27469
2011,동대문구,휘발유(무연),사업용,78,0,0,0,78
2011,동대문구,휘발유(유연),비사업용,3,0,0,0,3
2011,중랑구,CNG,비사업용,10,2,22,0,34
2011,중랑구,CNG,사업용,6,401,0,0,407
2011,중랑구,경유,비사업용,16560,3858,10975,37,31430
2011,중랑구,경유,사업용,24,108,2028,170,2330
2011,중랑구,기타연료,비사업용,2,9,17,0,28
2011,중랑구,기타연료,사업용,0,0,4,0,4
2011,중랑구,엘피지,비사업용,9249,2609,2595,0,14453
2011,중랑구,엘피지,사업용,5393,0,525,2,5920
2011,중랑구,전기,비사업용,2,0,0,0,2
2011,중랑구,전기,사업용,0,9,0,0,9
2011,중랑구,하이브리드(LPG+전기),비사업용,66,0,0,0,66
2011,중랑구,하이브리드(휘발유+전기),비사업용,95,0,0,0,95
2011,중랑구,휘발유,비사업용,18367,15,27,0,18409
2011,중랑구,휘발유,사업용,15,0,0,0,15
2011,중랑구,휘발유(무연),비사업용,30764,50,30,0,30844
2011,중랑구,휘발유(무연),사업용,24,0,1,0,25
2011,성북구,CNG,비사업용,4,2,6,0,12
2011,성북구,CNG,사업용,2,767,0,0,769
2011,성북구,경유,비사업용,20116,4101,8996,29,33242
2011,성북구,경유,사업용,15,211,1253,34,1513
2011,성북구,기타연료,비사업용,3,9,44,2,58
2011,성북구,기타연료,사업용,0,0,1,0,1
2011,성북구,엘피지,비사업용,9282,2497,1964,3,13746
2011,성북구,엘피지,사업용,2771,1,444,0,3216
2011,성북구,전기,비사업용,2,0,0,0,2
2011,성북구,하이브리드(LPG+전기),비사업용,67,0,0,0,67
2011,성북구,하이브리드(휘발유+전기),비사업용,175,0,0,0,175
2011,성북구,휘발유,비사업용,25248,12,33,0,25293
2011,성북구,휘발유,사업용,16,0,0,0,16
2011,성북구,휘발유(무연),비사업용,38048,47,25,0,38120
2011,성북구,휘발유(무연),사업용,9,0,0,0,9
2011,성북구,휘발유(유연),비사업용,1,0,0,0,1
2011,강북구,CNG,비사업용,8,1,16,0,25
2011,강북구,CNG,사업용,7,646,0,0,653
2011,강북구,경유,비사업용,11991,2795,6861,27,21674
2011,강북구,경유,사업용,2,98,982,27,1109
2011,강북구,기타연료,비사업용,2,1,8,0,11
2011,강북구,기타연료,사업용,0,0,1,0,1
2011,강북구,엘피지,비사업용,7085,2070,1676,0,10831
2011,강북구,엘피지,사업용,2410,0,443,0,2853
2011,강북구,전기,비사업용,1,0,0,0,1
2011,강북구,하이브리드(LPG+전기),비사업용,40,0,0,0,40
2011,강북구,하이브리드(휘발유+전기),비사업용,96,0,0,0,96
2011,강북구,휘발유,비사업용,13073,11,22,0,13106
2011,강북구,휘발유,사업용,3,0,0,0,3
2011,강북구,휘발유(무연),비사업용,23682,36,12,0,23730
2011,강북구,휘발유(무연),사업용,1,0,0,0,1
2011,강북구,휘발유(유연),비사업용,1,0,0,0,1
2011,도봉구,CNG,비사업용,4,2,8,0,14
2011,도봉구,CNG,사업용,170,351,0,0,521
2011,도봉구,경유,비사업용,15164,3056,7866,26,26112
2011,도봉구,경유,사업용,45,165,938,75,1223
2011,도봉구,기타연료,비사업용,2,7,20,0,29
2011,도봉구,기타연료,사업용,0,0,7,0,7
2011,도봉구,엘피지,비사업용,8036,2262,1849,1,12148
2011,도봉구,엘피지,사업용,5458,4,276,0,5738
2011,도봉구,전기,비사업용,2,0,0,0,2
2011,도봉구,하이브리드(LPG+전기),비사업용,91,0,0,0,91
2011,도봉구,하이브리드(휘발유+전기),비사업용,118,0,0,0,118
2011,도봉구,휘발유,비사업용,17640,7,18,0,17665
2011,도봉구,휘발유,사업용,61,0,0,0,61
2011,도봉구,휘발유(무연),비사업용,30594,26,21,0,30641
2011,도봉구,휘발유(무연),사업용,52,0,0,0,52
2011,도봉구,휘발유(유연),비사업용,4,0,0,0,4
2011,노원구,CNG,비사업용,21,4,10,0,35
2011,노원구,CNG,사업용,8,609,2,0,619
2011,노원구,경유,비사업용,26175,4695,10710,36,41616
2011,노원구,경유,사업용,74,201,1346,90,1711
2011,노원구,기타연료,비사업용,3,10,38,0,51
2011,노원구,기타연료,사업용,0,0,12,0,12
2011,노원구,엘피지,비사업용,14335,3272,2389,0,19996
2011,노원구,엘피지,사업용,6722,5,443,0,7170
2011,노원구,전기,비사업용,1,0,0,0,1
2011,노원구,하이브리드(LPG+전기),비사업용,93,0,0,0,93
2011,노원구,하이브리드(휘발유+전기),비사업용,186,0,0,0,186
2011,노원구,휘발유,비사업용,31219,12,34,0,31265
2011,노원구,휘발유,사업용,61,0,0,0,61
2011,노원구,휘발유(무연),비사업용,52277,51,35,0,52363
2011,노원구,휘발유(무연),사업용,60,0,0,0,60
2011,노원구,휘발유(유연),비사업용,5,0,0,0,5
2011,은평구,CNG,비사업용,7,2,16,0,25
2011,은평구,CNG,사업용,15,624,0,0,639
2011,은평구,경유,비사업용,19063,4201,10344,32,33640
2011,은평구,경유,사업용,13,101,1250,63,1427
2011,은평구,기타연료,비사업용,4,4,24,0,32
2011,은평구,기타연료,사업용,0,0,5,0,5
2011,은평구,엘피지,비사업용,10093,2735,2176,0,15004
2011,은평구,엘피지,사업용,3807,1,371,0,4179
2011,은평구,전기,비사업용,1,0,0,0,1
2011,은평구,태양열,비사업용,1,0,0,0,1
2011,은평구,하이브리드(LPG+전기),비사업용,85,0,0,0,85
2011,은평구,하이브리드(휘발유+전기),비사업용,156,0,0,0,156
2011,은평구,휘발유,비사업용,24007,19,31,0,24057
2011,은평구,휘발유,사업용,17,0,0,0,17
2011,은평구,휘발유(무연),비사업용,39200,61,33,0,39294
2011,은평구,휘발유(무연),사업용,7,0,0,0,7
2011,은평구,휘발유(유연),비사업용,2,0,0,0,2
2011,서대문구,CNG,비사업용,4,6,14,0,24
2011,서대문구,CNG,사업용,7,297,0,0,304
2011,서대문구,경유,비사업용,12395,2731,6253,34,21413
2011,서대문구,경유,사업용,6,128,1233,62,1429
2011,서대문구,기타연료,비사업용,3,4,20,0,27
2011,서대문구,기타연료,사업용,0,0,15,0,15
2011,서대문구,엘피지,비사업용,5959,1572,1220,1,8752
2011,서대문구,엘피지,사업용,2450,0,232,0,2682
2011,서대문구,전기,비사업용,2,0,0,0,2
2011,서대문구,하이브리드(LPG+전기),비사업용,50,0,0,0,50
2011,서대문구,하이브리드(휘발유+전기),비사업용,129,0,0,0,129
2011,서대문구,휘발유,비사업용,17130,14,32,0,17176
2011,서대문구,휘발유,사업용,24,0,0,0,24
2011,서대문구,휘발유(무연),비사업용,25935,40,20,0,25995
2011,서대문구,휘발유(무연),사업용,15,0,0,0,15
2011,서대문구,휘발유(유연),비사업용,2,0,0,0,2
2011,마포구,CNG,비사업용,11,3,16,0,30
2011,마포구,CNG,사업용,3,288,0,0,291
2011,마포구,경유,비사업용,17784,3514,9566,78,30942
2011,마포구,경유,사업용,139,398,2175,175,2887
2011,마포구,기타연료,비사업용,4,23,30,1,58
2011,마포구,기타연료,사업용,0,0,78,0,78
2011,마포구,엘피지,비사업용,7491,1961,1733,2,11187
2011,마포구,엘피지,사업용,2863,2,235,0,3100
2011,마포구,전기,비사업용,5,0,0,0,5
2011,마포구,하이브리드(LPG+전기),비사업용,65,0,0,0,65
2011,마포구,하이브리드(휘발유+전기),비사업용,176,0,0,0,176
2011,마포구,휘발유,비사업용,26490,24,44,3,26561
2011,마포구,휘발유,사업용,219,0,0,0,219
2011,마포구,휘발유(무연),비사업용,35481,46,47,0,35574
2011,마포구,휘발유(무연),사업용,223,0,0,0,223
2011,마포구,휘발유(유연),비사업용,2,0,0,0,2
2011,양천구,CNG,비사업용,14,2,11,0,27
2011,양천구,CNG,사업용,21,667,0,0,688
2011,양천구,경유,비사업용,22522,4197,12216,85,39020
2011,양천구,경유,사업용,29,265,2067,298,2659
2011,양천구,기타연료,비사업용,3,12,35,1,51
2011,양천구,기타연료,사업용,0,0,83,0,83
2011,양천구,엘피지,비사업용,11222,2978,2455,0,16655
2011,양천구,엘피지,사업용,5028,7,353,0,5388
2011,양천구,전기,비사업용,1,0,0,0,1
2011,양천구,하이브리드(LPG+전기),비사업용,105,0,0,0,105
2011,양천구,하이브리드(휘발유+전기),비사업용,191,0,0,0,191
2011,양천구,휘발유,비사업용,33549,17,19,0,33585
2011,양천구,휘발유,사업용,57,0,0,0,57
2011,양천구,휘발유(무연),비사업용,48088,44,39,0,48171
2011,양천구,휘발유(무연),사업용,18,0,1,0,19
2011,양천구,휘발유(유연),비사업용,1,0,0,0,1
2011,강서구,CNG,비사업용,26,7,18,0,51
2011,강서구,CNG,사업용,52,392,0,0,444
2011,강서구,경유,비사업용,26576,5226,15086,88,46976
2011,강서구,경유,사업용,1684,929,2138,98,4849
2011,강서구,기타연료,비사업용,5,9,73,3,90
2011,강서구,기타연료,사업용,0,0,9,0,9
2011,강서구,엘피지,비사업용,14547,3698,3194,3,21442
2011,강서구,엘피지,사업용,8110,3,454,0,8567
2011,강서구,전기,비사업용,3,0,0,0,3
2011,강서구,하이브리드(LPG+전기),비사업용,108,0,0,0,108
2011,강서구,하이브리드(LPG+전기),사업용,3,0,0,0,3
2011,강서구,하이브리드(휘발유+전기),비사업용,211,0,0,0,211
2011,강서구,하이브리드(휘발유+전기),사업용,2,0,0,0,2
2011,강서구,휘발유,비사업용,36157,20,31,0,36208
2011,강서구,휘발유,사업용,2261,5,0,0,2266
2011,강서구,휘발유(무연),비사업용,54715,63,51,0,54829
2011,강서구,휘발유(무연),사업용,3096,1,0,0,3097
2011,구로구,CNG,비사업용,8,0,14,0,22
2011,구로구,CNG,사업용,16,334,0,0,350
2011,구로구,경유,비사업용,21611,4472,13376,44,39503
2011,구로구,경유,사업용,1187,1014,1912,58,4171
2011,구로구,기타연료,비사업용,3,9,27,0,39
2011,구로구,기타연료,사업용,0,0,18,0,18
2011,구로구,엘피지,비사업용,10034,2468,2201,2,14705
2011,구로구,엘피지,사업용,6227,58,359,0,6644
2011,구로구,전기,비사업용,1,0,0,0,1
2011,구로구,하이브리드(LPG+전기),비사업용,79,0,0,0,79
2011,구로구,하이브리드(LPG+전기),사업용,3,0,0,0,3
2011,구로구,하이브리드(휘발유+전기),비사업용,154,0,0,0,154
2011,구로구,하이브리드(휘발유+전기),사업용,1,0,0,0,1
2011,구로구,휘발유,비사업용,25970,13,30,0,26013
2011,구로구,휘발유,사업용,1752,1,0,0,1753
2011,구로구,휘발유(무연),비사업용,39133,33,34,0,39200
2011,구로구,휘발유(무연),사업용,972,0,0,0,972
2011,구로구,휘발유(유연),비사업용,3,0,0,0,3
2011,금천구,CNG,비사업용,8,1,12,0,21
2011,금천구,CNG,사업용,4,388,0,0,392
2011,금천구,경유,비사업용,11841,2948,9434,27,24250
2011,금천구,경유,사업용,12,67,1820,38,1937
2011,금천구,기타연료,비사업용,1,1,16,0,18
2011,금천구,기타연료,사업용,0,0,21,0,21
2011,금천구,엘피지,비사업용,5487,1708,1746,2,8943
2011,금천구,엘피지,사업용,2232,0,248,0,2480
2011,금천구,전기,비사업용,7,0,0,0,7
2011,금천구,하이브리드(LPG+전기),비사업용,51,0,0,0,51
2011,금천구,하이브리드(경유+전기),비사업용,0,1,0,0,1
2011,금천구,하이브리드(휘발유+전기),비사업용,92,0,0,0,92
2011,금천구,휘발유,비사업용,14046,9,33,0,14088
2011,금천구,휘발유,사업용,4,0,0,0,4
2011,금천구,휘발유(무연),비사업용,21620,17,29,0,21666
2011,금천구,휘발유(무연),사업용,13,0,0,0,13
2011,금천구,휘발유(유연),비사업용,2,0,0,0,2
2011,영등포구,CNG,비사업용,21,2,38,0,61
2011,영등포구,CNG,사업용,10,65,0,0,75
2011,영등포구,경유,비사업용,21425,4733,16904,216,43278
2011,영등포구,경유,사업용,99,473,4050,376,4998
2011,영등포구,기타연료,비사업용,5,10,47,3,65
2011,영등포구,기타연료,사업용,0,0,142,4,146
2011,영등포구,엘피지,비사업용,8653,2237,2357,0,13247
2011,영등포구,엘피지,사업용,3654,5,397,4,4060
2011,영등포구,전기,비사업용,4,0,0,0,4
2011,영등포구,하이브리드(LPG+전기),비사업용,164,0,0,0,164
2011,영등포구,하이브리드(LPG+전기),사업용,6,0,0,0,6
2011,영등포구,하이브리드(휘발유+전기),비사업용,233,0,0,0,233
2011,영등포구,휘발유,비사업용,30777,32,57,1,30867
2011,영등포구,휘발유,사업용,260,0,0,0,260
2011,영등포구,휘발유(무연),비사업용,40260,53,52,0,40365
2011,영등포구,휘발유(무연),사업용,162,0,0,0,162
2011,영등포구,휘발유(유연),비사업용,1,0,0,0,1
2011,동작구,CNG,비사업용,10,0,11,0,21
2011,동작구,CNG,사업용,3,51,0,0,54
2011,동작구,경유,비사업용,15750,2867,7364,45,26026
2011,동작구,경유,사업용,7,109,972,50,1138
2011,동작구,기타연료,비사업용,1,3,24,0,28
2011,동작구,기타연료,사업용,0,0,7,0,7
2011,동작구,엘피지,비사업용,7889,1853,1480,1,11223
2011,동작구,엘피지,사업용,1314,0,211,0,1525
2011,동작구,전기,비사업용,3,0,0,0,3
2011,동작구,하이브리드(LPG+전기),비사업용,99,0,0,0,99
2011,동작구,하이브리드(휘발유+전기),비사업용,188,0,0,0,188
2011,동작구,휘발유,비사업용,23256,15,16,0,23287
2011,동작구,휘발유,사업용,1,0,0,0,1
2011,동작구,휘발유(무연),비사업용,33147,30,23,0,33200
2011,동작구,휘발유(유연),비사업용,1,1,0,0,2
2011,관악구,CNG,비사업용,6,0,23,0,29
2011,관악구,CNG,사업용,7,228,0,0,235
2011,관악구,경유,비사업용,19248,3996,9822,19,33085
2011,관악구,경유,사업용,214,85,1493,103,1895
2011,관악구,기타연료,비사업용,2,3,26,0,31
2011,관악구,기타연료,사업용,0,0,8,0,8
2011,관악구,엘피지,비사업용,9953,2616,2171,0,14740
2011,관악구,엘피지,사업용,3007,2,344,0,3353
2011,관악구,전기,비사업용,1,0,0,0,1
2011,관악구,하이브리드(LPG+전기),비사업용,109,0,0,0,109
2011,관악구,하이브리드(휘발유+전기),비사업용,163,0,0,0,163
2011,관악구,하이브리드(휘발유+전기),사업용,1,0,0,0,1
2011,관악구,휘발유,비사업용,25135,15,36,1,25187
2011,관악구,휘발유,사업용,183,0,0,0,183
2011,관악구,휘발유(무연),비사업용,39906,39,33,0,39978
2011,관악구,휘발유(무연),사업용,91,0,1,0,92
2011,서초구,CNG,비사업용,19,1,25,0,45
2011,서초구,CNG,사업용,7,392,0,0,399
2011,서초구,경유,비사업용,22512,4014,11565,110,38201
2011,서초구,경유,사업용,712,392,4627,146,5877
2011,서초구,기타연료,비사업용,14,17,97,1,129
2011,서초구,기타연료,사업용,0,0,96,3,99
2011,서초구,엘피지,비사업용,6245,1857,1589,0,9691
2011,서초구,엘피지,사업용,2752,12,144,1,2909
2011,서초구,전기,비사업용,4,0,0,0,4
2011,서초구,하이브리드(LPG+전기),비사업용,165,0,0,0,165
2011,서초구,하이브리드(휘발유+전기),비사업용,1430,0,0,0,1430
2011,서초구,휘발유,비사업용,54546,55,63,1,54665
2011,서초구,휘발유,사업용,1455,1,0,0,1456
2011,서초구,휘발유(무연),비사업용,54611,82,49,1,54743
2011,서초구,휘발유(무연),사업용,1281,0,0,0,1281
2011,서초구,휘발유(유연),비사업용,3,0,0,0,3
2011,강남구,CNG,비사업용,38,6,25,0,69
2011,강남구,CNG,사업용,20,189,0,0,209
2011,강남구,LNG,비사업용,1,0,0,0,1
2011,강남구,경유,비사업용,30493,5140,14256,102,49991
2011,강남구,경유,사업용,3800,1395,1521,135,6851
2011,강남구,기타연료,비사업용,21,18,92,15,146
2011,강남구,기타연료,사업용,0,11,281,1,293
2011,강남구,엘피지,비사업용,8726,2553,2124,4,13407
2011,강남구,엘피지,사업용,10772,31,126,0,10929
2011,강남구,전기,비사업용,18,0,0,0,18
2011,강남구,태양열,비사업용,2,0,0,0,2
2011,강남구,하이브리드(LPG+전기),비사업용,132,0,0,0,132
2011,강남구,하이브리드(LPG+전기),사업용,395,0,0,0,395
2011,강남구,하이브리드(휘발유+전기),비사업용,1217,0,0,0,1217
2011,강남구,하이브리드(휘발유+전기),사업용,15,0,0,0,15
2011,강남구,휘발유,비사업용,75756,67,107,1,75931
2011,강남구,휘발유,사업용,6870,4,0,0,6874
2011,강남구,휘발유(무연),비사업용,71999,115,106,2,72222
2011,강남구,휘발유(무연),사업용,7745,1,0,0,7746
2011,강남구,휘발유(유연),비사업용,7,0,0,0,7
2011,송파구,CNG,비사업용,33,2,55,0,90
2011,송파구,CNG,사업용,104,839,0,0,943
2011,송파구,경유,비사업용,33198,5518,17777,58,56551
2011,송파구,경유,사업용,138,721,2933,159,3951
2011,송파구,기타연료,비사업용,5,16,61,2,84
2011,송파구,기타연료,사업용,0,0,65,0,65
2011,송파구,엘피지,비사업용,13082,3439,3215,0,19736
2011,송파구,엘피지,사업용,4889,5,536,0,5430
2011,송파구,전기,비사업용,2,0,0,0,2
2011,송파구,하이브리드(LPG+전기),비사업용,169,0,0,0,169
2011,송파구,하이브리드(LPG+전기),사업용,1,0,0,0,1
2011,송파구,하이브리드(휘발유+전기),비사업용,326,0,0,0,326
2011,송파구,하이브리드(휘발유+전기),사업용,2,0,0,0,2
2011,송파구,휘발유,비사업용,57134,23,73,1,57231
2011,송파구,휘발유,사업용,226,2,0,0,228
2011,송파구,휘발유(무연),비사업용,69957,71,48,0,70076
2011,송파구,휘발유(무연),사업용,146,0,1,0,147
2011,송파구,휘발유(유연),비사업용,4,0,0,0,4
2011,강동구,CNG,비사업용,17,0,21,0,38
2011,강동구,CNG,사업용,111,197,0,0,308
2011,강동구,경유,비사업용,22797,4146,12566,39,39548
2011,강동구,경유,사업용,257,540,1648,174,2619
2011,강동구,기타연료,비사업용,6,20,29,1,56
2011,강동구,기타연료,사업용,0,0,39,0,39
2011,강동구,엘피지,비사업용,11796,3679,2804,3,18282
2011,강동구,엘피지,사업용,4977,4,421,1,5403
2011,강동구,전기,비사업용,1,0,0,0,1
2011,강동구,하이브리드(LPG+전기),비사업용,99,0,0,0,99
2011,강동구,하이브리드(휘발유+전기),비사업용,188,0,0,0,188
2011,강동구,휘발유,비사업용,29942,24,40,0,30006
2011,강동구,휘발유,사업용,481,0,0,0,481
2011,강동구,휘발유(무연),비사업용,44424,44,48,0,44516
2011,강동구,휘발유(무연),사업용,563,0,0,0,563
2011,강동구,휘발유(유연),비사업용,3,0,0,0,3
2012,합계,계,계,2447876,162723,353905,4680,2969184
2012,종로구,CNG,비사업용,8,4,18,0,30
2012,종로구,CNG,사업용,1,97,0,0,98
2012,종로구,경유,비사업용,8148,3380,5138,101,16767
2012,종로구,경유,사업용,57,259,656,25,997
2012,종로구,기타연료,비사업용,2,7,24,3,36
2012,종로구,기타연료,사업용,0,0,72,0,72
2012,종로구,엘피지,비사업용,2613,758,619,3,3993
2012,종로구,엘피지,사업용,263,0,149,0,412
2012,종로구,전기,비사업용,10,0,0,0,10
2012,종로구,하이브리드(LPG+전기),비사업용,58,0,0,0,58
2012,종로구,하이브리드(휘발유+전기),비사업용,362,0,0,0,362
2012,종로구,휘발유,비사업용,13273,25,45,0,13343
2012,종로구,휘발유,사업용,50,0,0,0,50
2012,종로구,휘발유(무연),비사업용,15145,51,18,1,15215
2012,종로구,휘발유(무연),사업용,75,0,0,0,75
2012,종로구,휘발유(유연),비사업용,3,0,0,0,3
2012,중구,CNG,비사업용,7,4,16,0,27
2012,중구,CNG,사업용,3,6,0,0,9
2012,중구,경유,비사업용,10648,2881,5522,95,19146
2012,중구,경유,사업용,962,504,1537,128,3131
2012,중구,기타연료,비사업용,4,4,42,12,62
2012,중구,기타연료,사업용,0,0,74,0,74
2012,중구,엘피지,비사업용,2248,778,711,1,3738
2012,중구,엘피지,사업용,1659,9,110,0,1778
2012,중구,전기,비사업용,24,0,0,0,24
2012,중구,하이브리드(LPG+전기),비사업용,47,0,0,0,47
2012,중구,하이브리드(LPG+전기),사업용,17,0,0,0,17
2012,중구,하이브리드(휘발유+전기),비사업용,287,0,0,0,287
2012,중구,하이브리드(휘발유+전기),사업용,9,0,0,0,9
2012,중구,휘발유,비사업용,18370,40,28,4,18442
2012,중구,휘발유,사업용,1104,2,0,0,1106
2012,중구,휘발유(무연),비사업용,14567,33,32,0,14632
2012,중구,휘발유(무연),사업용,2285,1,0,0,2286
2012,중구,휘발유(유연),비사업용,1,0,0,0,1
2012,용산구,CNG,비사업용,8,10,26,1,45
2012,용산구,CNG,사업용,2,11,0,0,13
2012,용산구,경유,비사업용,11625,2385,5776,22,19808
2012,용산구,경유,사업용,79,60,724,28,891
2012,용산구,기타연료,비사업용,917,9,32,1,959
2012,용산구,기타연료,사업용,0,0,7,0,7
2012,용산구,엘피지,비사업용,3882,1055,871,0,5808
2012,용산구,엘피지,사업용,802,0,127,0,929
2012,용산구,전기,비사업용,2,0,0,0,2
2012,용산구,하이브리드(LPG+전기),비사업용,83,0,0,0,83
2012,용산구,하이브리드(LPG+전기),사업용,1,0,0,0,1
2012,용산구,하이브리드(휘발유+전기),비사업용,365,0,0,0,365
2012,용산구,휘발유,비사업용,22424,20,53,1,22498
2012,용산구,휘발유,사업용,132,0,0,0,132
2012,용산구,휘발유(무연),비사업용,24463,60,31,0,24554
2012,용산구,휘발유(무연),사업용,34,0,0,0,34
2012,용산구,휘발유(유연),비사업용,2,0,0,0,2
2012,성동구,CNG,비사업용,20,3,17,0,40
2012,성동구,CNG,사업용,4,203,0,0,207
2012,성동구,경유,비사업용,14992,2725,8345,41,26103
2012,성동구,경유,사업용,109,230,1216,77,1632
2012,성동구,기타연료,비사업용,4,10,29,1,44
2012,성동구,기타연료,사업용,0,0,8,0,8
2012,성동구,엘피지,비사업용,6166,1306,1397,0,8869
2012,성동구,엘피지,사업용,2523,1,331,0,2855
2012,성동구,전기,비사업용,14,0,0,0,14
2012,성동구,하이브리드(LPG+전기),비사업용,93,0,0,0,93
2012,성동구,하이브리드(LPG+전기),사업용,1,0,0,0,1
2012,성동구,하이브리드(휘발유+전기),비사업용,347,0,0,0,347
2012,성동구,하이브리드(휘발유+전기),사업용,2,0,0,0,2
2012,성동구,휘발유,비사업용,20462,3,13,0,20478
2012,성동구,휘발유,사업용,166,0,0,0,166
2012,성동구,휘발유(무연),비사업용,26611,21,3,0,26635
2012,성동구,휘발유(무연),사업용,209,0,0,0,209
2012,성동구,휘발유(유연),비사업용,1,0,0,0,1
2012,광진구,CNG,비사업용,13,2,12,0,27
2012,광진구,CNG,사업용,69,358,0,0,427
2012,광진구,경유,비사업용,16007,3082,8900,22,28011
2012,광진구,경유,사업용,57,321,1215,141,1734
2012,광진구,기타연료,비사업용,2,10,28,0,40
2012,광진구,기타연료,사업용,0,0,2,0,2
2012,광진구,엘피지,비사업용,6542,1656,1571,1,9770
2012,광진구,엘피지,사업용,2758,3,290,4,3055
2012,광진구,전기,비사업용,4,0,0,0,4
2012,광진구,하이브리드(LPG+전기),비사업용,77,0,0,0,77
2012,광진구,하이브리드(휘발유+전기),비사업용,360,0,0,0,360
2012,광진구,하이브리드(휘발유+전기),사업용,4,0,0,0,4
2012,광진구,휘발유,비사업용,21356,6,19,0,21381
2012,광진구,휘발유,사업용,94,0,0,0,94
2012,광진구,휘발유(무연),비사업용,29566,40,33,0,29639
2012,광진구,휘발유(무연),사업용,71,0,0,0,71
2012,동대문구,CNG,비사업용,17,2,22,0,41
2012,동대문구,CNG,사업용,11,15,0,0,26
2012,동대문구,경유,비사업용,16029,3470,10015,37,29551
2012,동대문구,경유,사업용,90,212,1867,83,2252
2012,동대문구,기타연료,비사업용,3,9,25,1,38
2012,동대문구,기타연료,사업용,0,0,5,0,5
2012,동대문구,엘피지,비사업용,7165,1725,1874,3,10767
2012,동대문구,엘피지,사업용,2442,0,425,0,2867
2012,동대문구,전기,비사업용,3,0,0,0,3
2012,동대문구,하이브리드(LPG+전기),비사업용,70,0,0,0,70
2012,동대문구,하이브리드(휘발유+전기),비사업용,291,0,0,0,291
2012,동대문구,휘발유,비사업용,18961,11,33,0,19005
2012,동대문구,휘발유,사업용,55,0,0,0,55
2012,동대문구,휘발유(무연),비사업용,27227,39,30,0,27296
2012,동대문구,휘발유(무연),사업용,103,0,0,0,103
2012,동대문구,휘발유(유연),비사업용,3,0,0,0,3
2012,중랑구,CNG,비사업용,10,3,18,0,31
2012,중랑구,CNG,사업용,6,402,0,0,408
2012,중랑구,경유,비사업용,17554,3818,10915,38,32325
2012,중랑구,경유,사업용,21,109,1958,168,2256
2012,중랑구,기타연료,비사업용,2,10,35,0,47
2012,중랑구,기타연료,사업용,0,0,4,0,4
2012,중랑구,엘피지,비사업용,9092,2278,2318,0,13688
2012,중랑구,엘피지,사업용,5372,0,544,2,5918
2012,중랑구,전기,비사업용,2,0,0,0,2
2012,중랑구,전기,사업용,0,9,0,0,9
2012,중랑구,하이브리드(LPG+전기),비사업용,69,0,0,0,69
2012,중랑구,하이브리드(휘발유+전기),비사업용,243,0,0,0,243
2012,중랑구,휘발유,비사업용,18551,14,27,0,18592
2012,중랑구,휘발유,사업용,16,0,0,0,16
2012,중랑구,휘발유(무연),비사업용,30296,50,31,0,30377
2012,중랑구,휘발유(무연),사업용,33,0,1,0,34
2012,성북구,CNG,비사업용,8,2,8,0,18
2012,성북구,CNG,사업용,5,769,0,0,774
2012,성북구,경유,비사업용,21212,4108,8915,23,34258
2012,성북구,경유,사업용,15,250,1181,42,1488
2012,성북구,기타연료,비사업용,5,11,59,2,77
2012,성북구,기타연료,사업용,0,0,1,0,1
2012,성북구,엘피지,비사업용,9105,2188,1754,2,13049
2012,성북구,엘피지,사업용,2691,0,450,0,3141
2012,성북구,전기,비사업용,3,0,0,0,3
2012,성북구,하이브리드(LPG+전기),비사업용,71,0,0,0,71
2012,성북구,하이브리드(휘발유+전기),비사업용,415,0,0,0,415
2012,성북구,휘발유,비사업용,25379,13,29,0,25421
2012,성북구,휘발유,사업용,10,0,0,0,10
2012,성북구,휘발유(무연),비사업용,37530,42,25,0,37597
2012,성북구,휘발유(무연),사업용,14,0,0,0,14
2012,성북구,휘발유(유연),비사업용,2,0,0,0,2
2012,강북구,CNG,비사업용,10,1,14,0,25
2012,강북구,CNG,사업용,6,650,0,0,656
2012,강북구,경유,비사업용,12785,2843,6854,32,22514
2012,강북구,경유,사업용,7,102,995,36,1140
2012,강북구,기타연료,비사업용,2,1,11,0,14
2012,강북구,기타연료,사업용,0,0,1,0,1
2012,강북구,엘피지,비사업용,7009,1811,1491,0,10311
2012,강북구,엘피지,사업용,2457,0,442,0,2899
2012,강북구,전기,비사업용,2,0,0,0,2
2012,강북구,하이브리드(LPG+전기),비사업용,46,0,0,0,46
2012,강북구,하이브리드(휘발유+전기),비사업용,214,0,0,0,214
2012,강북구,휘발유,비사업용,13366,10,19,0,13395
2012,강북구,휘발유,사업용,14,0,0,0,14
2012,강북구,휘발유(무연),비사업용,23410,31,7,0,23448
2012,강북구,휘발유(무연),사업용,42,0,0,0,42
2012,강북구,휘발유(유연),비사업용,1,0,0,0,1
2012,도봉구,CNG,비사업용,9,2,9,0,20
2012,도봉구,CNG,사업용,200,350,0,0,550
2012,도봉구,LNG,사업용,1,0,0,0,1
2012,도봉구,경유,비사업용,15922,3088,7845,32,26887
2012,도봉구,경유,사업용,39,178,916,84,1217
2012,도봉구,기타연료,비사업용,2,8,25,0,35
2012,도봉구,기타연료,사업용,0,0,7,0,7
2012,도봉구,엘피지,비사업용,7885,1933,1600,1,11419
2012,도봉구,엘피지,사업용,5325,5,274,0,5604
2012,도봉구,전기,비사업용,2,0,0,0,2
2012,도봉구,하이브리드(CNG+전기),사업용,0,1,0,0,1
2012,도봉구,하이브리드(LPG+전기),비사업용,97,0,0,0,97
2012,도봉구,하이브리드(휘발유+전기),비사업용,278,0,0,0,278
2012,도봉구,휘발유,비사업용,17627,6,19,0,17652
2012,도봉구,휘발유,사업용,47,0,0,0,47
2012,도봉구,휘발유(무연),비사업용,29849,23,19,0,29891
2012,도봉구,휘발유(무연),사업용,47,0,0,0,47
2012,도봉구,휘발유(유연),비사업용,4,0,0,0,4
2012,노원구,CNG,비사업용,25,3,10,0,38
2012,노원구,CNG,사업용,9,615,2,0,626
2012,노원구,경유,비사업용,27414,4608,10587,33,42642
2012,노원구,경유,사업용,55,200,1314,123,1692
2012,노원구,기타연료,비사업용,3,12,47,0,62
2012,노원구,기타연료,사업용,0,0,11,0,11
2012,노원구,엘피지,비사업용,14169,2812,2124,0,19105
2012,노원구,엘피지,사업용,6577,1,452,0,7030
2012,노원구,전기,비사업용,3,0,0,0,3
2012,노원구,하이브리드(LPG+전기),비사업용,99,0,0,0,99
2012,노원구,하이브리드(휘발유+전기),비사업용,444,0,0,0,444
2012,노원구,하이브리드(휘발유+전기),사업용,1,0,0,0,1
2012,노원구,휘발유,비사업용,31274,10,35,0,31319
2012,노원구,휘발유,사업용,56,0,0,0,56
2012,노원구,휘발유(무연),비사업용,50709,48,30,0,50787
2012,노원구,휘발유(무연),사업용,50,0,0,0,50
2012,노원구,휘발유(유연),비사업용,4,0,0,0,4
2012,은평구,CNG,비사업용,10,2,16,0,28
2012,은평구,CNG,사업용,20,639,0,0,659
2012,은평구,경유,비사업용,20742,4265,10480,30,35517
2012,은평구,경유,사업용,18,41,1247,96,1402
2012,은평구,기타연료,비사업용,3,5,28,0,36
2012,은평구,기타연료,사업용,0,0,4,0,4
2012,은평구,엘피지,비사업용,10167,2454,1993,0,14614
2012,은평구,엘피지,사업용,3972,1,363,0,4336
2012,은평구,전기,비사업용,1,0,0,0,1
2012,은평구,태양열,비사업용,1,0,0,0,1
2012,은평구,하이브리드(LPG+전기),비사업용,89,0,0,0,89
2012,은평구,하이브리드(휘발유+전기),비사업용,325,0,0,0,325
2012,은평구,휘발유,비사업용,24894,19,28,0,24941
2012,은평구,휘발유,사업용,21,0,0,0,21
2012,은평구,휘발유(무연),비사업용,39542,57,32,0,39631
2012,은평구,휘발유(무연),사업용,9,0,0,0,9
2012,서대문구,CNG,비사업용,15,6,15,0,36
2012,서대문구,CNG,사업용,8,304,0,0,312
2012,서대문구,경유,비사업용,13327,2764,6232,38,22361
2012,서대문구,경유,사업용,5,105,1253,69,1432
2012,서대문구,기타연료,비사업용,2,7,19,0,28
2012,서대문구,기타연료,사업용,0,0,15,0,15
2012,서대문구,엘피지,비사업용,5877,1368,1089,1,8335
2012,서대문구,엘피지,사업용,2514,0,237,0,2751
2012,서대문구,전기,비사업용,5,0,0,0,5
2012,서대문구,하이브리드(LPG+전기),비사업용,60,0,0,0,60
2012,서대문구,하이브리드(휘발유+전기),비사업용,288,0,0,0,288
2012,서대문구,휘발유,비사업용,17529,15,29,1,17574
2012,서대문구,휘발유,사업용,34,0,0,0,34
2012,서대문구,휘발유(무연),비사업용,25716,36,20,0,25772
2012,서대문구,휘발유(무연),사업용,15,0,0,0,15
2012,서대문구,휘발유(유연),비사업용,2,0,0,0,2
2012,마포구,CNG,비사업용,14,3,21,0,38
2012,마포구,CNG,사업용,4,293,0,0,297
2012,마포구,경유,비사업용,18624,3553,9478,97,31752
2012,마포구,경유,사업용,173,497,2121,177,2968
2012,마포구,기타연료,비사업용,5,27,40,1,73
2012,마포구,기타연료,사업용,0,0,77,0,77
2012,마포구,엘피지,비사업용,7176,1688,1551,4,10419
2012,마포구,엘피지,사업용,2864,1,234,0,3099
2012,마포구,전기,비사업용,7,0,0,0,7
2012,마포구,하이브리드(LPG+전기),비사업용,69,0,0,0,69
2012,마포구,하이브리드(휘발유+전기),비사업용,419,0,0,0,419
2012,마포구,휘발유,비사업용,26406,22,48,5,26481
2012,마포구,휘발유,사업용,178,0,0,0,178
2012,마포구,휘발유(무연),비사업용,34476,43,45,0,34564
2012,마포구,휘발유(무연),사업용,309,0,0,0,309
2012,마포구,휘발유(유연),비사업용,2,0,0,0,2
2012,양천구,CNG,비사업용,21,2,13,0,36
2012,양천구,CNG,사업용,23,668,0,0,691
2012,양천구,경유,비사업용,23890,4213,12153,101,40357
2012,양천구,경유,사업용,32,448,2125,310,2915
2012,양천구,기타연료,비사업용,3,14,44,1,62
2012,양천구,기타연료,사업용,0,0,53,0,53
2012,양천구,엘피지,비사업용,11105,2516,2200,1,15822
2012,양천구,엘피지,사업용,4871,5,340,0,5216
2012,양천구,전기,비사업용,1,0,0,0,1
2012,양천구,하이브리드(LPG+전기),비사업용,117,0,0,0,117
2012,양천구,하이브리드(휘발유+전기),비사업용,466,0,0,0,466
2012,양천구,휘발유,비사업용,33928,14,19,0,33961
2012,양천구,휘발유,사업용,49,0,0,0,49
2012,양천구,휘발유(무연),비사업용,47007,42,38,0,47087
2012,양천구,휘발유(무연),사업용,31,0,1,0,32
2012,양천구,휘발유(유연),비사업용,2,0,0,0,2
2012,강서구,CNG,비사업용,30,9,19,0,58
2012,강서구,CNG,사업용,56,403,0,0,459
2012,강서구,경유,비사업용,28012,5302,15074,93,48481
2012,강서구,경유,사업용,1230,886,2217,184,4517
2012,강서구,기타연료,비사업용,7,8,82,3,100
2012,강서구,기타연료,사업용,0,0,10,0,10
2012,강서구,엘피지,비사업용,14385,3241,2924,3,20553
2012,강서구,엘피지,사업용,7775,3,426,1,8205
2012,강서구,전기,비사업용,3,0,0,0,3
2012,강서구,하이브리드(LPG+전기),비사업용,111,0,0,0,111
2012,강서구,하이브리드(LPG+전기),사업용,3,0,0,0,3
2012,강서구,하이브리드(휘발유+전기),비사업용,503,0,0,0,503
2012,강서구,하이브리드(휘발유+전기),사업용,129,0,0,0,129
2012,강서구,휘발유,비사업용,36112,21,28,0,36161
2012,강서구,휘발유,사업용,1393,4,0,0,1397
2012,강서구,휘발유(무연),비사업용,53258,54,48,0,53360
2012,강서구,휘발유(무연),사업용,2620,1,0,0,2621
2012,구로구,CNG,비사업용,17,0,15,0,32
2012,구로구,CNG,사업용,18,336,0,0,354
2012,구로구,경유,비사업용,22842,4527,13249,51,40669
2012,구로구,경유,사업용,519,975,1971,68,3533
2012,구로구,기타연료,비사업용,3,13,33,0,49
2012,구로구,기타연료,사업용,0,0,18,0,18
2012,구로구,엘피지,비사업용,9939,2159,1952,2,14052
2012,구로구,엘피지,사업용,4747,32,354,0,5133
2012,구로구,전기,비사업용,3,0,0,0,3
2012,구로구,전기,사업용,20,0,0,0,20
2012,구로구,하이브리드(LPG+전기),비사업용,93,0,0,0,93
2012,구로구,하이브리드(LPG+전기),사업용,6,0,0,0,6
2012,구로구,하이브리드(휘발유+전기),비사업용,407,0,0,0,407
2012,구로구,하이브리드(휘발유+전기),사업용,1,0,0,0,1
2012,구로구,휘발유,비사업용,26339,10,30,0,26379
2012,구로구,휘발유,사업용,521,1,0,0,522
2012,구로구,휘발유(무연),비사업용,38684,29,33,0,38746
2012,구로구,휘발유(무연),사업용,536,0,0,0,536
2012,구로구,휘발유(유연),비사업용,1,0,0,0,1
2012,금천구,CNG,비사업용,13,1,13,0,27
2012,금천구,CNG,사업용,6,390,0,0,396
2012,금천구,경유,비사업용,12862,3030,9475,21,25388
2012,금천구,경유,사업용,38,49,1865,43,1995
2012,금천구,기타연료,비사업용,1,2,16,0,19
2012,금천구,기타연료,사업용,0,0,20,0,20
2012,금천구,엘피지,비사업용,5453,1475,1508,4,8440
2012,금천구,엘피지,사업용,2346,0,233,0,2579
2012,금천구,전기,비사업용,6,0,0,0,6
2012,금천구,하이브리드(LPG+전기),비사업용,64,0,0,0,64
2012,금천구,하이브리드(LPG+전기),사업용,1,0,0,0,1
2012,금천구,하이브리드(경유+전기),비사업용,0,1,0,0,1
2012,금천구,하이브리드(휘발유+전기),비사업용,220,0,0,0,220
2012,금천구,하이브리드(휘발유+전기),사업용,6,0,0,0,6
2012,금천구,휘발유,비사업용,14299,9,37,0,14345
2012,금천구,휘발유,사업용,15,0,0,0,15
2012,금천구,휘발유(무연),비사업용,21980,17,25,0,22022
2012,금천구,휘발유(무연),사업용,35,0,0,0,35
2012,금천구,휘발유(유연),비사업용,2,0,0,0,2
2012,영등포구,CNG,비사업용,33,2,44,0,79
2012,영등포구,CNG,사업용,12,66,0,0,78
2012,영등포구,경유,비사업용,21937,4665,17198,221,44021
2012,영등포구,경유,사업용,63,437,3670,314,4484
2012,영등포구,기타연료,비사업용,5,9,55,3,72
2012,영등포구,기타연료,사업용,0,0,177,3,180
2012,영등포구,엘피지,비사업용,8327,1961,2120,4,12412
2012,영등포구,엘피지,사업용,3493,1,374,2,3870
2012,영등포구,전기,비사업용,10,0,0,0,10
2012,영등포구,하이브리드(LPG+전기),비사업용,172,0,0,0,172
2012,영등포구,하이브리드(LPG+전기),사업용,6,0,0,0,6
2012,영등포구,하이브리드(휘발유+전기),비사업용,588,0,0,0,588
2012,영등포구,하이브리드(휘발유+전기),사업용,7,0,0,0,7
2012,영등포구,휘발유,비사업용,30767,29,51,1,30848
2012,영등포구,휘발유,사업용,102,0,0,0,102
2012,영등포구,휘발유(무연),비사업용,40009,55,45,0,40109
2012,영등포구,휘발유(무연),사업용,228,0,0,0,228
2012,영등포구,휘발유(유연),비사업용,1,0,0,0,1
2012,동작구,CNG,비사업용,11,0,11,0,22
2012,동작구,CNG,사업용,3,63,0,0,66
2012,동작구,경유,비사업용,16969,2903,7292,56,27220
2012,동작구,경유,사업용,6,51,1003,63,1123
2012,동작구,기타연료,비사업용,1,6,26,0,33
2012,동작구,기타연료,사업용,0,0,6,0,6
2012,동작구,엘피지,비사업용,7799,1584,1335,1,10719
2012,동작구,엘피지,사업용,1280,0,199,0,1479
2012,동작구,전기,비사업용,4,0,0,0,4
2012,동작구,하이브리드(LPG+전기),비사업용,104,0,0,0,104
2012,동작구,하이브리드(휘발유+전기),비사업용,416,0,0,0,416
2012,동작구,휘발유,비사업용,24074,13,17,0,24104
2012,동작구,휘발유,사업용,3,0,0,0,3
2012,동작구,휘발유(무연),비사업용,33334,26,25,0,33385
2012,동작구,휘발유(무연),사업용,2,0,0,0,2
2012,동작구,휘발유(유연),비사업용,2,1,0,0,3
2012,관악구,CNG,비사업용,14,0,24,1,39
2012,관악구,CNG,사업용,10,232,0,0,242
2012,관악구,경유,비사업용,20311,4064,9802,25,34202
2012,관악구,경유,사업용,204,105,1465,111,1885
2012,관악구,기타연료,비사업용,2,4,31,0,37
2012,관악구,기타연료,사업용,0,0,6,0,6
2012,관악구,엘피지,비사업용,9850,2284,1951,0,14085
2012,관악구,엘피지,사업용,3040,1,343,0,3384
2012,관악구,전기,비사업용,3,0,0,0,3
2012,관악구,하이브리드(LPG+전기),비사업용,123,0,0,0,123
2012,관악구,하이브리드(휘발유+전기),비사업용,436,0,0,0,436
2012,관악구,하이브리드(휘발유+전기),사업용,1,0,0,0,1
2012,관악구,휘발유,비사업용,25119,13,32,0,25164
2012,관악구,휘발유,사업용,135,0,0,0,135
2012,관악구,휘발유(무연),비사업용,39064,33,29,0,39126
2012,관악구,휘발유(무연),사업용,122,0,0,0,122
2012,서초구,CNG,비사업용,26,4,25,1,56
2012,서초구,CNG,사업용,7,404,0,0,411
2012,서초구,경유,비사업용,24026,4077,11597,124,39824
2012,서초구,경유,사업용,792,460,4509,186,5947
2012,서초구,기타연료,비사업용,8,30,105,1,144
2012,서초구,기타연료,사업용,0,0,119,5,124
2012,서초구,엘피지,비사업용,6184,1625,1455,1,9265
2012,서초구,엘피지,사업용,2732,9,128,1,2870
2012,서초구,전기,비사업용,16,0,0,0,16
2012,서초구,하이브리드(LPG+전기),비사업용,175,0,0,0,175
2012,서초구,하이브리드(휘발유+전기),비사업용,1916,0,0,0,1916
2012,서초구,하이브리드(휘발유+전기),사업용,11,0,0,0,11
2012,서초구,휘발유,비사업용,55208,53,61,1,55323
2012,서초구,휘발유,사업용,1036,1,0,0,1037
2012,서초구,휘발유(무연),비사업용,53292,76,49,1,53418
2012,서초구,휘발유(무연),사업용,1683,0,0,0,1683
2012,서초구,휘발유(유연),비사업용,3,0,0,0,3
2012,강남구,CNG,비사업용,48,2,34,0,84
2012,강남구,CNG,사업용,18,193,0,0,211
2012,강남구,LNG,비사업용,1,0,0,0,1
2012,강남구,경유,비사업용,31353,5245,14024,105,50727
2012,강남구,경유,사업용,2777,1238,1646,123,5784
2012,강남구,기타연료,비사업용,18,26,108,12,164
2012,강남구,기타연료,사업용,0,6,186,0,192
2012,강남구,엘피지,비사업용,8688,2237,1917,2,12844
2012,강남구,엘피지,사업용,9321,18,132,0,9471
2012,강남구,전기,비사업용,29,0,0,0,29
2012,강남구,전기,사업용,12,0,0,0,12
2012,강남구,태양열,비사업용,3,0,0,0,3
2012,강남구,하이브리드(LPG+전기),비사업용,139,0,0,0,139
2012,강남구,하이브리드(LPG+전기),사업용,353,0,0,0,353
2012,강남구,하이브리드(휘발유+전기),비사업용,2059,0,0,0,2059
2012,강남구,하이브리드(휘발유+전기),사업용,34,0,0,0,34
2012,강남구,휘발유,비사업용,74485,65,95,1,74646
2012,강남구,휘발유,사업용,3555,8,0,0,3563
2012,강남구,휘발유(무연),비사업용,69558,108,100,2,69768
2012,강남구,휘발유(무연),사업용,7278,1,0,0,7279
2012,강남구,휘발유(유연),비사업용,10,0,0,0,10
2012,송파구,CNG,비사업용,46,3,54,0,103
2012,송파구,CNG,사업용,117,833,0,0,950
2012,송파구,경유,비사업용,34852,5427,17514,62,57855
2012,송파구,경유,사업용,148,709,3090,153,4100
2012,송파구,기타연료,비사업용,4,22,81,2,109
2012,송파구,기타연료,사업용,0,0,51,0,51
2012,송파구,엘피지,비사업용,12648,2936,2904,0,18488
2012,송파구,엘피지,사업용,4742,5,502,0,5249
2012,송파구,전기,비사업용,5,0,0,0,5
2012,송파구,하이브리드(CNG+전기),사업용,0,4,0,0,4
2012,송파구,하이브리드(LPG+전기),비사업용,175,0,0,0,175
2012,송파구,하이브리드(휘발유+전기),비사업용,812,0,0,0,812
2012,송파구,하이브리드(휘발유+전기),사업용,3,0,0,0,3
2012,송파구,휘발유,비사업용,57192,21,71,1,57285
2012,송파구,휘발유,사업용,183,4,0,0,187
2012,송파구,휘발유(무연),비사업용,67993,56,45,0,68094
2012,송파구,휘발유(무연),사업용,185,0,0,0,185
2012,송파구,휘발유(유연),비사업용,3,0,0,0,3
2012,강동구,CNG,비사업용,23,0,22,0,45
2012,강동구,CNG,사업용,135,195,0,0,330
2012,강동구,경유,비사업용,23847,4086,12340,39,40312
2012,강동구,경유,사업용,92,556,1603,188,2439
2012,강동구,기타연료,비사업용,6,23,33,2,64
2012,강동구,기타연료,사업용,0,0,41,0,41
2012,강동구,엘피지,비사업용,11566,2808,2451,2,16827
2012,강동구,엘피지,사업용,5067,1,407,0,5475
2012,강동구,전기,비사업용,2,0,0,0,2
2012,강동구,하이브리드(CNG+전기),사업용,0,2,0,0,2
2012,강동구,하이브리드(LPG+전기),비사업용,114,0,0,0,114
2012,강동구,하이브리드(휘발유+전기),비사업용,447,0,0,0,447
2012,강동구,하이브리드(휘발유+전기),사업용,3,0,0,0,3
2012,강동구,휘발유,비사업용,29815,26,41,0,29882
2012,강동구,휘발유,사업용,78,0,0,0,78
2012,강동구,휘발유(무연),비사업용,43503,42,42,0,43587
2012,강동구,휘발유(무연),사업용,224,1,0,0,225
2012,강동구,휘발유(유연),비사업용,3,0,0,0,3
2013,합계,계,계,2462515,156871,349285,5206,2973877
2013,종로구,CNG,비사업용,10,3,21,0,34
2013,종로구,CNG,사업용,1,97,0,0,98
2013,종로구,경유,비사업용,8528,3432,4770,100,16830
2013,종로구,경유,사업용,59,266,597,128,1050
2013,종로구,기타연료,비사업용,1,8,26,3,38
2013,종로구,기타연료,사업용,0,0,116,0,116
2013,종로구,엘피지,비사업용,2448,651,541,3,3643
2013,종로구,엘피지,사업용,265,0,142,0,407
2013,종로구,전기,비사업용,10,0,0,0,10
2013,종로구,하이브리드(LPG+전기),비사업용,52,0,0,0,52
2013,종로구,하이브리드(휘발유+전기),비사업용,451,0,0,0,451
2013,종로구,휘발유,비사업용,12951,25,45,1,13022
2013,종로구,휘발유,사업용,39,0,0,0,39
2013,종로구,휘발유(무연),비사업용,14495,54,16,1,14566
2013,종로구,휘발유(무연),사업용,117,0,0,0,117
2013,종로구,휘발유(유연),비사업용,3,0,0,0,3
2013,중구,CNG,비사업용,4,3,16,0,23
2013,중구,CNG,사업용,4,6,1,0,11
2013,중구,경유,비사업용,10422,3032,5444,120,19018
2013,중구,경유,사업용,492,359,1393,185,2429
2013,중구,기타연료,비사업용,4,7,34,7,52
2013,중구,기타연료,사업용,0,0,82,0,82
2013,중구,엘피지,비사업용,2093,675,645,2,3415
2013,중구,엘피지,사업용,1167,52,89,0,1308
2013,중구,전기,비사업용,32,1,0,0,33
2013,중구,전기,사업용,70,0,0,0,70
2013,중구,하이브리드(LPG+전기),비사업용,45,0,0,0,45
2013,중구,하이브리드(LPG+전기),사업용,16,0,0,0,16
2013,중구,하이브리드(경유+전기),비사업용,3,0,0,0,3
2013,중구,하이브리드(휘발유+전기),비사업용,335,0,0,0,335
2013,중구,하이브리드(휘발유+전기),사업용,3,0,0,0,3
2013,중구,휘발유,비사업용,15359,36,24,4,15423
2013,중구,휘발유,사업용,424,0,0,0,424
2013,중구,휘발유(무연),비사업용,13654,35,30,0,13719
2013,중구,휘발유(무연),사업용,1118,3,0,0,1121
2013,중구,휘발유(유연),비사업용,1,0,0,0,1
2013,용산구,CNG,비사업용,9,0,25,1,35
2013,용산구,CNG,사업용,2,12,0,0,14
2013,용산구,경유,비사업용,12554,2443,5685,25,20707
2013,용산구,경유,사업용,58,69,753,27,907
2013,용산구,기타연료,비사업용,718,10,32,2,762
2013,용산구,기타연료,사업용,0,0,3,0,3
2013,용산구,엘피지,비사업용,3730,895,801,0,5426
2013,용산구,엘피지,사업용,787,0,106,0,893
2013,용산구,전기,비사업용,3,0,0,0,3
2013,용산구,전기,사업용,32,0,0,0,32
2013,용산구,하이브리드(LPG+전기),비사업용,87,0,0,0,87
2013,용산구,하이브리드(LPG+전기),사업용,1,0,0,0,1
2013,용산구,하이브리드(휘발유+전기),비사업용,462,0,0,0,462
2013,용산구,휘발유,비사업용,22493,20,59,1,22573
2013,용산구,휘발유,사업용,96,0,0,0,96
2013,용산구,휘발유(무연),비사업용,23614,55,25,0,23694
2013,용산구,휘발유(무연),사업용,74,0,0,0,74
2013,용산구,휘발유(유연),비사업용,2,0,0,0,2
2013,성동구,CNG,비사업용,23,3,17,0,43
2013,성동구,CNG,사업용,4,204,0,0,208
2013,성동구,경유,비사업용,16414,2819,8507,48,27788
2013,성동구,경유,사업용,145,260,1158,89,1652
2013,성동구,기타연료,비사업용,4,18,38,1,61
2013,성동구,기타연료,사업용,0,0,7,0,7
2013,성동구,엘피지,비사업용,6052,1108,1313,1,8474
2013,성동구,엘피지,사업용,2557,3,323,0,2883
2013,성동구,전기,비사업용,14,0,0,0,14
2013,성동구,전기,사업용,2,0,0,0,2
2013,성동구,하이브리드(LPG+전기),비사업용,101,0,0,0,101
2013,성동구,하이브리드(LPG+전기),사업용,2,0,0,0,2
2013,성동구,하이브리드(휘발유+전기),비사업용,508,0,0,0,508
2013,성동구,하이브리드(휘발유+전기),사업용,5,0,0,0,5
2013,성동구,휘발유,비사업용,20974,3,17,0,20994
2013,성동구,휘발유,사업용,102,0,0,0,102
2013,성동구,휘발유(무연),비사업용,26518,21,5,0,26544
2013,성동구,휘발유(무연),사업용,207,0,0,0,207
2013,성동구,휘발유(유연),비사업용,1,0,0,0,1
2013,광진구,CNG,비사업용,8,2,13,0,23
2013,광진구,CNG,사업용,112,357,0,0,469
2013,광진구,경유,비사업용,17152,3085,8842,23,29102
2013,광진구,경유,사업용,131,318,1353,147,1949
2013,광진구,기타연료,비사업용,2,17,37,0,56
2013,광진구,기타연료,사업용,0,0,5,0,5
2013,광진구,엘피지,비사업용,6290,1455,1448,2,9195
2013,광진구,엘피지,사업용,2691,2,283,27,3003
2013,광진구,전기,비사업용,4,0,0,0,4
2013,광진구,하이브리드(LPG+전기),비사업용,86,0,0,0,86
2013,광진구,하이브리드(휘발유+전기),비사업용,465,0,0,0,465
2013,광진구,하이브리드(휘발유+전기),사업용,10,0,0,0,10
2013,광진구,휘발유,비사업용,21488,7,23,0,21518
2013,광진구,휘발유,사업용,109,0,0,0,109
2013,광진구,휘발유(무연),비사업용,29023,39,33,0,29095
2013,광진구,휘발유(무연),사업용,116,0,0,0,116
2013,동대문구,CNG,비사업용,15,2,23,0,40
2013,동대문구,CNG,사업용,16,16,0,0,32
2013,동대문구,경유,비사업용,17192,3568,9849,42,30651
2013,동대문구,경유,사업용,135,215,2042,92,2484
2013,동대문구,기타연료,비사업용,3,10,40,2,55
2013,동대문구,기타연료,사업용,0,0,5,0,5
2013,동대문구,엘피지,비사업용,7052,1443,1669,1,10165
2013,동대문구,엘피지,사업용,2366,0,427,0,2793
2013,동대문구,전기,비사업용,3,0,0,0,3
2013,동대문구,하이브리드(LPG+전기),비사업용,67,0,0,0,67
2013,동대문구,하이브리드(휘발유+전기),비사업용,434,0,0,0,434
2013,동대문구,휘발유,비사업용,19261,10,30,0,19301
2013,동대문구,휘발유,사업용,57,0,0,0,57
2013,동대문구,휘발유(무연),비사업용,27175,31,32,0,27238
2013,동대문구,휘발유(무연),사업용,141,0,0,0,141
2013,동대문구,휘발유(유연),비사업용,3,0,0,0,3
2013,중랑구,CNG,비사업용,16,3,13,0,32
2013,중랑구,CNG,사업용,7,402,0,0,409
2013,중랑구,경유,비사업용,18835,3953,10948,44,33780
2013,중랑구,경유,사업용,25,124,2068,176,2393
2013,중랑구,기타연료,비사업용,2,11,42,1,56
2013,중랑구,기타연료,사업용,0,0,5,0,5
2013,중랑구,엘피지,비사업용,8906,1984,2047,0,12937
2013,중랑구,엘피지,사업용,5371,0,526,2,5899
2013,중랑구,전기,비사업용,2,0,0,0,2
2013,중랑구,전기,사업용,0,9,0,0,9
2013,중랑구,하이브리드(LPG+전기),비사업용,71,0,0,0,71
2013,중랑구,하이브리드(휘발유+전기),비사업용,360,0,0,0,360
2013,중랑구,휘발유,비사업용,18682,12,28,0,18722
2013,중랑구,휘발유,사업용,18,2,0,0,20
2013,중랑구,휘발유(무연),비사업용,30061,47,27,0,30135
2013,중랑구,휘발유(무연),사업용,42,0,0,0,42
2013,성북구,CNG,비사업용,13,2,8,0,23
2013,성북구,CNG,사업용,6,770,0,0,776
2013,성북구,경유,비사업용,22627,4152,8766,27,35572
2013,성북구,경유,사업용,7,252,1264,47,1570
2013,성북구,기타연료,비사업용,4,18,68,2,92
2013,성북구,기타연료,사업용,0,0,1,0,1
2013,성북구,엘피지,비사업용,8826,1844,1593,2,12265
2013,성북구,엘피지,사업용,2593,0,434,0,3027
2013,성북구,전기,비사업용,4,0,0,0,4
2013,성북구,하이브리드(LPG+전기),비사업용,76,0,0,0,76
2013,성북구,하이브리드(휘발유+전기),비사업용,577,0,0,0,577
2013,성북구,휘발유,비사업용,25347,12,30,0,25389
2013,성북구,휘발유,사업용,3,0,0,0,3
2013,성북구,휘발유(무연),비사업용,36846,37,23,0,36906
2013,성북구,휘발유(무연),사업용,1,0,0,0,1
2013,강북구,CNG,비사업용,13,1,14,0,28
2013,강북구,CNG,사업용,5,667,1,0,673
2013,강북구,경유,비사업용,13612,2918,6827,43,23400
2013,강북구,경유,사업용,14,84,1076,51,1225
2013,강북구,기타연료,비사업용,1,3,14,1,19
2013,강북구,기타연료,사업용,0,0,1,0,1
2013,강북구,엘피지,비사업용,6783,1490,1344,0,9617
2013,강북구,엘피지,사업용,2513,0,448,0,2961
2013,강북구,전기,비사업용,1,0,0,0,1
2013,강북구,하이브리드(LPG+전기),비사업용,48,0,0,0,48
2013,강북구,하이브리드(휘발유+전기),비사업용,269,0,0,0,269
2013,강북구,하이브리드(휘발유+전기),사업용,2,0,0,0,2
2013,강북구,휘발유,비사업용,13260,11,19,0,13290
2013,강북구,휘발유,사업용,14,0,0,0,14
2013,강북구,휘발유(무연),비사업용,22746,28,8,0,22782
2013,강북구,휘발유(무연),사업용,67,0,0,0,67
2013,도봉구,CNG,비사업용,13,2,10,0,25
2013,도봉구,CNG,사업용,165,352,0,0,517
2013,도봉구,LNG,사업용,1,0,0,0,1
2013,도봉구,경유,비사업용,17020,3144,7858,38,28060
2013,도봉구,경유,사업용,51,117,1000,88,1256
2013,도봉구,기타연료,비사업용,2,12,34,1,49
2013,도봉구,기타연료,사업용,0,0,7,0,7
2013,도봉구,엘피지,비사업용,7661,1666,1427,1,10755
2013,도봉구,엘피지,사업용,5326,3,280,0,5609
2013,도봉구,전기,비사업용,2,0,0,0,2
2013,도봉구,하이브리드(CNG+전기),사업용,0,1,0,0,1
2013,도봉구,하이브리드(LPG+전기),비사업용,107,0,0,0,107
2013,도봉구,하이브리드(휘발유+전기),비사업용,376,0,0,0,376
2013,도봉구,휘발유,비사업용,17688,6,20,0,17714
2013,도봉구,휘발유,사업용,32,0,0,0,32
2013,도봉구,휘발유(무연),비사업용,29080,22,20,0,29122
2013,도봉구,휘발유(무연),사업용,63,0,0,0,63
2013,도봉구,휘발유(유연),비사업용,4,0,0,0,4
2013,노원구,CNG,비사업용,35,3,11,0,49
2013,노원구,CNG,사업용,9,615,1,0,625
2013,노원구,경유,비사업용,29052,4663,10441,41,44197
2013,노원구,경유,사업용,82,168,1476,150,1876
2013,노원구,기타연료,비사업용,3,15,57,0,75
2013,노원구,기타연료,사업용,0,0,11,0,11
2013,노원구,엘피지,비사업용,13688,2340,1895,1,17924
2013,노원구,엘피지,사업용,6044,0,439,0,6483
2013,노원구,전기,비사업용,4,0,0,0,4
2013,노원구,하이브리드(LPG+전기),비사업용,105,0,0,0,105
2013,노원구,하이브리드(휘발유+전기),비사업용,623,0,0,0,623
2013,노원구,휘발유,비사업용,31199,10,31,0,31240
2013,노원구,휘발유,사업용,33,0,0,0,33
2013,노원구,휘발유(무연),비사업용,49527,44,27,0,49598
2013,노원구,휘발유(무연),사업용,80,0,0,0,80
2013,노원구,휘발유(유연),비사업용,4,0,0,0,4
2013,은평구,CNG,비사업용,12,2,14,0,28
2013,은평구,CNG,사업용,17,680,0,0,697
2013,은평구,경유,비사업용,22351,4333,10474,32,37190
2013,은평구,경유,사업용,23,49,1580,110,1762
2013,은평구,기타연료,비사업용,4,8,51,0,63
2013,은평구,기타연료,사업용,0,0,4,0,4
2013,은평구,엘피지,비사업용,10019,2090,1826,0,13935
2013,은평구,엘피지,사업용,3899,1,352,0,4252
2013,은평구,전기,비사업용,2,0,0,0,2
2013,은평구,태양열,비사업용,1,0,0,0,1
2013,은평구,하이브리드(LPG+전기),비사업용,92,0,0,0,92
2013,은평구,하이브리드(휘발유+전기),비사업용,481,0,0,0,481
2013,은평구,휘발유,비사업용,25445,18,27,0,25490
2013,은평구,휘발유,사업용,20,0,0,0,20
2013,은평구,휘발유(무연),비사업용,39324,48,26,0,39398
2013,은평구,휘발유(무연),사업용,19,0,0,0,19
2013,서대문구,CNG,비사업용,14,6,15,0,35
2013,서대문구,CNG,사업용,8,270,0,0,278
2013,서대문구,경유,비사업용,14334,2839,6121,37,23331
2013,서대문구,경유,사업용,11,97,1298,74,1480
2013,서대문구,기타연료,비사업용,2,9,18,1,30
2013,서대문구,기타연료,사업용,0,0,16,0,16
2013,서대문구,엘피지,비사업용,5671,1151,990,0,7812
2013,서대문구,엘피지,사업용,2515,0,208,0,2723
2013,서대문구,전기,비사업용,4,0,0,0,4
2013,서대문구,하이브리드(LPG+전기),비사업용,57,0,0,0,57
2013,서대문구,하이브리드(경유+전기),비사업용,1,0,0,0,1
2013,서대문구,하이브리드(휘발유+전기),비사업용,404,0,0,0,404
2013,서대문구,휘발유,비사업용,17768,15,32,1,17816
2013,서대문구,휘발유,사업용,30,0,0,0,30
2013,서대문구,휘발유(무연),비사업용,25121,32,22,0,25175
2013,서대문구,휘발유(무연),사업용,23,0,0,0,23
2013,서대문구,휘발유(유연),비사업용,1,0,0,0,1
2013,마포구,CNG,비사업용,17,3,25,0,45
2013,마포구,CNG,사업용,3,294,0,0,297
2013,마포구,경유,비사업용,19870,3699,9511,118,33198
2013,마포구,경유,사업용,210,559,2168,167,3104
2013,마포구,기타연료,비사업용,2,26,46,0,74
2013,마포구,기타연료,사업용,0,0,44,0,44
2013,마포구,엘피지,비사업용,6816,1431,1390,2,9639
2013,마포구,엘피지,사업용,2764,1,238,0,3003
2013,마포구,전기,비사업용,7,0,0,0,7
2013,마포구,전기,사업용,126,0,0,0,126
2013,마포구,하이브리드(LPG+전기),비사업용,62,0,0,0,62
2013,마포구,하이브리드(휘발유+전기),비사업용,591,0,0,0,591
2013,마포구,하이브리드(휘발유+전기),사업용,12,0,0,0,12
2013,마포구,휘발유,비사업용,26465,22,48,4,26539
2013,마포구,휘발유,사업용,177,0,0,0,177
2013,마포구,휘발유(무연),비사업용,33871,41,42,0,33954
2013,마포구,휘발유(무연),사업용,646,0,0,0,646
2013,마포구,휘발유(유연),비사업용,1,0,0,0,1
2013,양천구,CNG,비사업용,25,2,14,0,41
2013,양천구,CNG,사업용,22,669,0,0,691
2013,양천구,경유,비사업용,25555,4183,12100,100,41938
2013,양천구,경유,사업용,36,489,2169,321,3015
2013,양천구,기타연료,비사업용,3,20,49,1,73
2013,양천구,기타연료,사업용,0,0,52,0,52
2013,양천구,엘피지,비사업용,10805,2149,2004,1,14959
2013,양천구,엘피지,사업용,4886,0,317,0,5203
2013,양천구,전기,비사업용,1,0,0,0,1
2013,양천구,하이브리드(LPG+전기),비사업용,112,0,0,0,112
2013,양천구,하이브리드(휘발유+전기),비사업용,660,0,0,0,660
2013,양천구,하이브리드(휘발유+전기),사업용,1,0,0,0,1
2013,양천구,휘발유,비사업용,34215,15,24,0,34254
2013,양천구,휘발유,사업용,40,10,0,0,50
2013,양천구,휘발유(무연),비사업용,46101,44,40,0,46185
2013,양천구,휘발유(무연),사업용,43,0,1,0,44
2013,양천구,휘발유(유연),비사업용,2,0,0,0,2
2013,강서구,CNG,비사업용,31,7,19,0,57
2013,강서구,CNG,사업용,48,406,0,0,454
2013,강서구,경유,비사업용,30104,5382,15249,89,50824
2013,강서구,경유,사업용,642,927,2207,174,3950
2013,강서구,기타연료,비사업용,5,12,77,3,97
2013,강서구,기타연료,사업용,0,0,12,0,12
2013,강서구,엘피지,비사업용,14109,2717,2702,2,19530
2013,강서구,엘피지,사업용,7631,1,415,0,8047
2013,강서구,전기,비사업용,2,0,0,0,2
2013,강서구,전기,사업용,35,0,0,0,35
2013,강서구,하이브리드(LPG+전기),비사업용,117,0,0,0,117
2013,강서구,하이브리드(LPG+전기),사업용,1,0,0,0,1
2013,강서구,하이브리드(휘발유+전기),비사업용,748,0,0,0,748
2013,강서구,하이브리드(휘발유+전기),사업용,258,0,0,0,258
2013,강서구,휘발유,비사업용,36453,22,33,0,36508
2013,강서구,휘발유,사업용,548,2,0,0,550
2013,강서구,휘발유(무연),비사업용,52972,52,43,1,53068
2013,강서구,휘발유(무연),사업용,1652,1,0,0,1653
2013,구로구,CNG,비사업용,23,0,15,0,38
2013,구로구,CNG,사업용,18,341,0,0,359
2013,구로구,경유,비사업용,24536,4757,13144,59,42496
2013,구로구,경유,사업용,921,753,2298,119,4091
2013,구로구,기타연료,비사업용,2,17,46,1,66
2013,구로구,기타연료,사업용,0,0,19,0,19
2013,구로구,엘피지,비사업용,9761,1813,1767,2,13343
2013,구로구,엘피지,사업용,5638,25,366,0,6029
2013,구로구,전기,비사업용,3,0,0,0,3
2013,구로구,전기,사업용,20,0,0,0,20
2013,구로구,하이브리드(LPG+전기),비사업용,92,0,0,0,92
2013,구로구,하이브리드(LPG+전기),사업용,3,0,0,0,3
2013,구로구,하이브리드(휘발유+전기),비사업용,598,0,0,0,598
2013,구로구,하이브리드(휘발유+전기),사업용,13,0,0,0,13
2013,구로구,휘발유,비사업용,26417,10,29,0,26456
2013,구로구,휘발유,사업용,436,1,0,0,437
2013,구로구,휘발유(무연),비사업용,38325,25,28,0,38378
2013,구로구,휘발유(무연),사업용,1650,1,0,0,1651
2013,구로구,휘발유(유연),비사업용,1,0,0,0,1
2013,금천구,CNG,비사업용,21,1,13,0,35
2013,금천구,CNG,사업용,5,395,0,0,400
2013,금천구,경유,비사업용,13863,3195,9504,23,26585
2013,금천구,경유,사업용,122,59,1992,49,2222
2013,금천구,기타연료,비사업용,1,5,25,0,31
2013,금천구,기타연료,사업용,0,0,13,0,13
2013,금천구,엘피지,비사업용,5381,1235,1339,2,7957
2013,금천구,엘피지,사업용,4004,0,226,0,4230
2013,금천구,전기,비사업용,3,0,0,0,3
2013,금천구,하이브리드(LPG+전기),비사업용,75,0,0,0,75
2013,금천구,하이브리드(LPG+전기),사업용,5,0,0,0,5
2013,금천구,하이브리드(경유+전기),비사업용,0,1,0,0,1
2013,금천구,하이브리드(휘발유+전기),비사업용,310,0,0,0,310
2013,금천구,하이브리드(휘발유+전기),사업용,8,0,0,0,8
2013,금천구,휘발유,비사업용,14446,7,34,0,14487
2013,금천구,휘발유,사업용,31,0,0,0,31
2013,금천구,휘발유(무연),비사업용,22044,14,24,0,22082
2013,금천구,휘발유(무연),사업용,457,0,0,0,457
2013,금천구,휘발유(유연),비사업용,2,0,0,0,2
2013,영등포구,CNG,비사업용,19,2,34,0,55
2013,영등포구,CNG,사업용,17,74,0,0,91
2013,영등포구,경유,비사업용,23894,4713,16381,240,45228
2013,영등포구,경유,사업용,110,401,3808,303,4622
2013,영등포구,기타연료,비사업용,5,18,63,5,91
2013,영등포구,기타연료,사업용,0,0,136,3,139
2013,영등포구,엘피지,비사업용,8122,1655,1834,4,11615
2013,영등포구,엘피지,사업용,3273,1,356,2,3632
2013,영등포구,전기,비사업용,13,0,0,0,13
2013,영등포구,하이브리드(LPG+전기),비사업용,171,0,0,0,171
2013,영등포구,하이브리드(LPG+전기),사업용,5,0,0,0,5
2013,영등포구,하이브리드(휘발유+전기),비사업용,873,0,0,0,873
2013,영등포구,하이브리드(휘발유+전기),사업용,77,0,0,0,77
2013,영등포구,휘발유,비사업용,30803,25,48,1,30877
2013,영등포구,휘발유,사업용,80,0,0,0,80
2013,영등포구,휘발유(무연),비사업용,39251,52,41,0,39344
2013,영등포구,휘발유(무연),사업용,254,0,0,0,254
2013,영등포구,휘발유(유연),비사업용,2,0,0,0,2
2013,동작구,CNG,비사업용,10,0,11,0,21
2013,동작구,CNG,사업용,3,69,0,0,72
2013,동작구,경유,비사업용,18681,3040,7242,88,29051
2013,동작구,경유,사업용,6,41,1012,104,1163
2013,동작구,기타연료,비사업용,1,9,29,0,39
2013,동작구,기타연료,사업용,0,0,7,0,7
2013,동작구,엘피지,비사업용,7672,1373,1201,1,10247
2013,동작구,엘피지,사업용,1273,0,198,0,1471
2013,동작구,전기,비사업용,5,0,0,0,5
2013,동작구,하이브리드(LPG+전기),비사업용,109,0,0,0,109
2013,동작구,하이브리드(휘발유+전기),비사업용,595,0,0,0,595
2013,동작구,휘발유,비사업용,24844,12,17,0,24873
2013,동작구,휘발유(무연),비사업용,33497,24,25,0,33546
2013,동작구,휘발유(무연),사업용,2,0,0,0,2
2013,동작구,휘발유(유연),비사업용,1,0,0,0,1
2013,관악구,CNG,비사업용,19,0,24,1,44
2013,관악구,CNG,사업용,9,233,0,0,242
2013,관악구,경유,비사업용,21728,4088,9735,32,35583
2013,관악구,경유,사업용,179,95,1545,125,1944
2013,관악구,기타연료,비사업용,0,6,41,0,47
2013,관악구,기타연료,사업용,0,0,7,0,7
2013,관악구,엘피지,비사업용,9594,1954,1749,1,13298
2013,관악구,엘피지,사업용,2945,0,340,0,3285
2013,관악구,전기,비사업용,3,0,0,0,3
2013,관악구,하이브리드(LPG+전기),비사업용,113,0,0,0,113
2013,관악구,하이브리드(휘발유+전기),비사업용,587,0,0,0,587
2013,관악구,휘발유,비사업용,25043,14,34,0,25091
2013,관악구,휘발유,사업용,54,0,0,0,54
2013,관악구,휘발유(무연),비사업용,37985,32,31,0,38048
2013,관악구,휘발유(무연),사업용,102,0,0,0,102
2013,서초구,CNG,비사업용,34,2,26,1,63
2013,서초구,CNG,사업용,5,422,0,0,427
2013,서초구,경유,비사업용,26690,4289,11436,122,42537
2013,서초구,경유,사업용,700,436,4659,162,5957
2013,서초구,기타연료,비사업용,7,38,114,2,161
2013,서초구,기타연료,사업용,0,0,131,4,135
2013,서초구,엘피지,비사업용,6308,1422,1334,1,9065
2013,서초구,엘피지,사업용,2472,6,122,1,2601
2013,서초구,전기,비사업용,7,0,0,0,7
2013,서초구,하이브리드(LPG+전기),비사업용,174,0,0,0,174
2013,서초구,하이브리드(휘발유+전기),비사업용,2249,0,0,0,2249
2013,서초구,하이브리드(휘발유+전기),사업용,15,0,0,0,15
2013,서초구,휘발유,비사업용,55727,53,63,1,55844
2013,서초구,휘발유,사업용,600,1,0,0,601
2013,서초구,휘발유(무연),비사업용,52695,73,52,1,52821
2013,서초구,휘발유(무연),사업용,894,0,0,0,894
2013,서초구,휘발유(유연),비사업용,3,0,0,0,3
2013,강남구,CNG,비사업용,53,2,35,0,90
2013,강남구,CNG,사업용,14,195,0,0,209
2013,강남구,경유,비사업용,34824,5396,13962,116,54298
2013,강남구,경유,사업용,2482,1123,1804,134,5543
2013,강남구,기타연료,비사업용,16,32,108,4,160
2013,강남구,기타연료,사업용,0,1,191,0,192
2013,강남구,엘피지,비사업용,8562,1861,1718,1,12142
2013,강남구,엘피지,사업용,7871,14,125,0,8010
2013,강남구,전기,비사업용,30,0,0,0,30
2013,강남구,전기,사업용,13,0,0,0,13
2013,강남구,태양열,비사업용,3,0,0,0,3
2013,강남구,하이브리드(LPG+전기),비사업용,143,0,0,0,143
2013,강남구,하이브리드(LPG+전기),사업용,245,0,0,0,245
2013,강남구,하이브리드(휘발유+전기),비사업용,2589,0,0,0,2589
2013,강남구,하이브리드(휘발유+전기),사업용,243,0,0,0,243
2013,강남구,휘발유,비사업용,74046,68,101,1,74216
2013,강남구,휘발유,사업용,1948,8,0,0,1956
2013,강남구,휘발유(무연),비사업용,68185,100,99,2,68386
2013,강남구,휘발유(무연),사업용,6664,0,0,0,6664
2013,강남구,휘발유(유연),비사업용,11,0,0,0,11
2013,송파구,CNG,비사업용,53,3,51,0,107
2013,송파구,CNG,사업용,148,833,0,0,981
2013,송파구,경유,비사업용,37556,5425,17225,66,60272
2013,송파구,경유,사업용,177,709,3075,150,4111
2013,송파구,기타연료,비사업용,6,31,119,2,158
2013,송파구,기타연료,사업용,0,0,24,0,24
2013,송파구,엘피지,비사업용,12264,2484,2606,1,17355
2013,송파구,엘피지,사업용,4755,5,503,0,5263
2013,송파구,전기,비사업용,5,0,0,0,5
2013,송파구,하이브리드(CNG+전기),사업용,0,4,0,0,4
2013,송파구,하이브리드(LPG+전기),비사업용,188,0,0,0,188
2013,송파구,하이브리드(LPG+전기),사업용,1,0,0,0,1
2013,송파구,하이브리드(휘발유+전기),비사업용,1157,0,0,0,1157
2013,송파구,하이브리드(휘발유+전기),사업용,4,0,0,0,4
2013,송파구,휘발유,비사업용,57042,20,73,1,57136
2013,송파구,휘발유,사업용,146,4,0,0,150
2013,송파구,휘발유(무연),비사업용,66773,55,44,0,66872
2013,송파구,휘발유(무연),사업용,226,0,0,0,226
2013,송파구,휘발유(유연),비사업용,5,0,0,0,5
2013,강동구,CNG,비사업용,23,0,22,0,45
2013,강동구,CNG,사업용,142,195,0,0,337
2013,강동구,경유,비사업용,25312,4104,12397,35,41848
2013,강동구,경유,사업용,81,468,1661,190,2400
2013,강동구,기타연료,비사업용,6,30,50,2,88
2013,강동구,기타연료,사업용,0,0,29,0,29
2013,강동구,엘피지,비사업용,11348,2188,2158,2,15696
2013,강동구,엘피지,사업용,5087,1,398,0,5486
2013,강동구,전기,비사업용,3,0,0,0,3
2013,강동구,하이브리드(CNG+전기),사업용,0,2,0,0,2
2013,강동구,하이브리드(LPG+전기),비사업용,112,0,0,0,112
2013,강동구,하이브리드(휘발유+전기),비사업용,667,0,0,0,667
2013,강동구,하이브리드(휘발유+전기),사업용,5,0,0,0,5
2013,강동구,휘발유,비사업용,29881,26,42,0,29949
2013,강동구,휘발유,사업용,54,1,0,0,55
2013,강동구,휘발유(무연),비사업용,42710,35,36,0,42781
2013,강동구,휘발유(무연),사업용,221,2,0,0,223
2013,강동구,휘발유(유연),비사업용,2,0,0,0,2
2014,합계,계,계,2510742,149991,346980,5828,3013541
2014,종로구,CNG,비사업용,9,3,20,0,32
2014,종로구,CNG,사업용,1,96,0,0,97
2014,종로구,경유,비사업용,9081,3436,4696,100,17313
2014,종로구,경유,사업용,51,276,574,174,1075
2014,종로구,기타연료,비사업용,3,9,35,3,50
2014,종로구,기타연료,사업용,0,0,142,0,142
2014,종로구,엘피지,비사업용,2314,524,479,3,3320
2014,종로구,엘피지,사업용,256,0,135,0,391
2014,종로구,전기,비사업용,11,0,0,0,11
2014,종로구,하이브리드(LPG+전기),비사업용,40,0,0,0,40
2014,종로구,하이브리드(휘발유+전기),비사업용,527,0,0,0,527
2014,종로구,휘발유,비사업용,12566,25,45,1,12637
2014,종로구,휘발유,사업용,21,0,0,0,21
2014,종로구,휘발유(무연),비사업용,14458,49,16,1,14524
2014,종로구,휘발유(무연),사업용,132,0,0,0,132
2014,종로구,휘발유(유연),비사업용,3,0,0,0,3
2014,중구,CNG,비사업용,6,2,16,0,24
2014,중구,CNG,사업용,4,6,1,0,11
2014,중구,경유,비사업용,10751,2996,5450,111,19308
2014,중구,경유,사업용,538,327,1523,201,2589
2014,중구,기타연료,비사업용,4,11,38,7,60
2014,중구,기타연료,사업용,0,0,72,0,72
2014,중구,엘피지,비사업용,1980,576,568,1,3125
2014,중구,엘피지,사업용,1105,3,87,0,1195
2014,중구,전기,비사업용,36,1,0,0,37
2014,중구,전기,사업용,152,0,0,0,152
2014,중구,하이브리드(LPG+전기),비사업용,39,0,0,0,39
2014,중구,하이브리드(경유+전기),비사업용,16,0,0,0,16
2014,중구,하이브리드(휘발유+전기),비사업용,421,0,0,0,421
2014,중구,하이브리드(휘발유+전기),사업용,6,0,0,0,6
2014,중구,휘발유,비사업용,13416,29,28,2,13475
2014,중구,휘발유,사업용,233,3,0,0,236
2014,중구,휘발유(무연),비사업용,13285,26,30,0,13341
2014,중구,휘발유(무연),사업용,1168,2,0,0,1170
2014,용산구,CNG,비사업용,7,0,24,1,32
2014,용산구,CNG,사업용,1,18,0,0,19
2014,용산구,경유,비사업용,13634,2416,5694,26,21770
2014,용산구,경유,사업용,106,52,787,31,976
2014,용산구,기타연료,비사업용,584,15,39,2,640
2014,용산구,기타연료,사업용,0,0,2,0,2
2014,용산구,엘피지,비사업용,3485,780,729,0,4994
2014,용산구,엘피지,사업용,854,0,105,0,959
2014,용산구,전기,비사업용,5,0,0,0,5
2014,용산구,전기,사업용,32,0,0,0,32
2014,용산구,하이브리드(LPG+전기),비사업용,65,0,0,0,65
2014,용산구,하이브리드(경유+전기),비사업용,1,0,0,0,1
2014,용산구,하이브리드(휘발유+전기),비사업용,600,0,0,0,600
2014,용산구,휘발유,비사업용,22105,22,49,0,22176
2014,용산구,휘발유,사업용,71,0,0,0,71
2014,용산구,휘발유(무연),비사업용,22936,46,24,0,23006
2014,용산구,휘발유(무연),사업용,101,0,0,0,101
2014,용산구,휘발유(유연),비사업용,1,0,0,0,1
2014,성동구,CNG,비사업용,14,2,17,0,33
2014,성동구,CNG,사업용,104,160,0,0,264
2014,성동구,경유,비사업용,18275,2781,8428,52,29536
2014,성동구,경유,사업용,199,275,1337,97,1908
2014,성동구,기타연료,비사업용,4,22,43,2,71
2014,성동구,기타연료,사업용,0,0,8,0,8
2014,성동구,엘피지,비사업용,5711,917,1127,1,7756
2014,성동구,엘피지,사업용,2666,4,339,1,3010
2014,성동구,전기,비사업용,17,0,0,0,17
2014,성동구,전기,사업용,8,0,0,0,8
2014,성동구,하이브리드(LPG+전기),비사업용,97,0,0,0,97
2014,성동구,하이브리드(LPG+전기),사업용,2,0,0,0,2
2014,성동구,하이브리드(휘발유+전기),비사업용,664,0,0,0,664
2014,성동구,하이브리드(휘발유+전기),사업용,7,0,0,0,7
2014,성동구,휘발유,비사업용,21287,6,22,0,21315
2014,성동구,휘발유,사업용,74,0,0,0,74
2014,성동구,휘발유(무연),비사업용,26309,15,4,0,26328
2014,성동구,휘발유(무연),사업용,249,0,0,0,249
2014,광진구,CNG,비사업용,8,18,13,0,39
2014,광진구,CNG,사업용,2,359,0,0,361
2014,광진구,경유,비사업용,18650,2999,8705,22,30376
2014,광진구,경유,사업용,121,351,1340,178,1990
2014,광진구,기타연료,비사업용,2,20,47,0,69
2014,광진구,기타연료,사업용,0,0,5,0,5
2014,광진구,엘피지,비사업용,5990,1194,1239,1,8424
2014,광진구,엘피지,사업용,2421,1,282,47,2751
2014,광진구,전기,비사업용,8,0,0,0,8
2014,광진구,하이브리드(LPG+전기),비사업용,73,0,0,0,73
2014,광진구,하이브리드(휘발유+전기),비사업용,599,0,0,0,599
2014,광진구,하이브리드(휘발유+전기),사업용,12,0,0,0,12
2014,광진구,휘발유,비사업용,21310,8,22,0,21340
2014,광진구,휘발유,사업용,77,0,0,0,77
2014,광진구,휘발유(무연),비사업용,28498,33,30,0,28561
2014,광진구,휘발유(무연),사업용,113,0,0,0,113
2014,동대문구,CNG,비사업용,17,2,21,0,40
2014,동대문구,CNG,사업용,2,21,0,0,23
2014,동대문구,경유,비사업용,18954,3540,9907,46,32447
2014,동대문구,경유,사업용,218,275,1993,127,2613
2014,동대문구,기타연료,비사업용,3,15,52,1,71
2014,동대문구,기타연료,사업용,0,0,5,0,5
2014,동대문구,엘피지,비사업용,6812,1193,1521,1,9527
2014,동대문구,엘피지,사업용,2459,38,441,0,2938
2014,동대문구,전기,비사업용,3,0,0,0,3
2014,동대문구,하이브리드(LPG+전기),비사업용,71,0,0,0,71
2014,동대문구,하이브리드(휘발유+전기),비사업용,554,0,0,0,554
2014,동대문구,하이브리드(휘발유+전기),사업용,1,0,0,0,1
2014,동대문구,휘발유,비사업용,19454,10,31,0,19495
2014,동대문구,휘발유,사업용,70,0,0,0,70
2014,동대문구,휘발유(무연),비사업용,27162,32,30,0,27224
2014,동대문구,휘발유(무연),사업용,217,0,0,0,217
2014,동대문구,휘발유(유연),비사업용,2,0,0,0,2
2014,중랑구,CNG,비사업용,22,2,14,0,38
2014,중랑구,CNG,사업용,3,402,0,0,405
2014,중랑구,경유,비사업용,21044,3959,11139,55,36197
2014,중랑구,경유,사업용,52,136,2156,168,2512
2014,중랑구,기타연료,비사업용,2,14,58,3,77
2014,중랑구,기타연료,사업용,0,0,5,0,5
2014,중랑구,엘피지,비사업용,8687,1694,1820,0,12201
2014,중랑구,엘피지,사업용,5509,0,480,0,5989
2014,중랑구,전기,비사업용,3,0,0,0,3
2014,중랑구,전기,사업용,5,9,0,0,14
2014,중랑구,하이브리드(LPG+전기),비사업용,75,0,0,0,75
2014,중랑구,하이브리드(휘발유+전기),비사업용,453,0,0,0,453
2014,중랑구,휘발유,비사업용,19247,11,27,0,19285
2014,중랑구,휘발유,사업용,22,0,0,0,22
2014,중랑구,휘발유(무연),비사업용,30454,36,27,1,30518
2014,중랑구,휘발유(무연),사업용,119,0,0,0,119
2014,성북구,CNG,비사업용,21,2,8,0,31
2014,성북구,CNG,사업용,5,776,0,0,781
2014,성북구,경유,비사업용,24213,4103,8725,31,37072
2014,성북구,경유,사업용,12,273,1282,84,1651
2014,성북구,기타연료,비사업용,4,22,76,2,104
2014,성북구,엘피지,비사업용,8354,1512,1368,3,11237
2014,성북구,엘피지,사업용,2593,0,412,0,3005
2014,성북구,전기,비사업용,7,0,0,0,7
2014,성북구,하이브리드(LPG+전기),비사업용,82,0,0,0,82
2014,성북구,하이브리드(휘발유+전기),비사업용,774,0,0,0,774
2014,성북구,휘발유,비사업용,25023,13,29,0,25065
2014,성북구,휘발유(무연),비사업용,35876,32,20,0,35928
2014,성북구,휘발유(무연),사업용,1,0,0,0,1
2014,강북구,CNG,비사업용,16,1,14,0,31
2014,강북구,CNG,사업용,4,689,1,0,694
2014,강북구,경유,비사업용,14790,2874,6978,49,24691
2014,강북구,경유,사업용,6,76,939,73,1094
2014,강북구,기타연료,비사업용,1,7,21,1,30
2014,강북구,기타연료,사업용,0,0,1,0,1
2014,강북구,엘피지,비사업용,6428,1292,1214,0,8934
2014,강북구,엘피지,사업용,2632,0,303,0,2935
2014,강북구,전기,비사업용,2,0,0,0,2
2014,강북구,하이브리드(LPG+전기),비사업용,49,0,0,0,49
2014,강북구,하이브리드(휘발유+전기),비사업용,353,0,0,0,353
2014,강북구,휘발유,비사업용,13355,9,20,0,13384
2014,강북구,휘발유,사업용,15,0,0,0,15
2014,강북구,휘발유(무연),비사업용,22289,23,7,0,22319
2014,강북구,휘발유(무연),사업용,22,0,0,0,22
2014,도봉구,CNG,비사업용,13,2,10,0,25
2014,도봉구,CNG,사업용,95,350,0,0,445
2014,도봉구,경유,비사업용,18408,3079,7884,38,29409
2014,도봉구,경유,사업용,48,136,1319,114,1617
2014,도봉구,기타연료,비사업용,3,11,40,1,55
2014,도봉구,기타연료,사업용,0,0,7,0,7
2014,도봉구,엘피지,비사업용,7431,1344,1245,1,10021
2014,도봉구,엘피지,사업용,5219,2,377,0,5598
2014,도봉구,전기,비사업용,2,0,0,0,2
2014,도봉구,하이브리드(CNG+전기),사업용,0,5,0,0,5
2014,도봉구,하이브리드(LPG+전기),비사업용,104,0,0,0,104
2014,도봉구,하이브리드(휘발유+전기),비사업용,503,0,0,0,503
2014,도봉구,하이브리드(휘발유+전기),사업용,2,0,0,0,2
2014,도봉구,휘발유,비사업용,17844,8,19,0,17871
2014,도봉구,휘발유,사업용,23,0,0,0,23
2014,도봉구,휘발유(무연),비사업용,28634,19,17,0,28670
2014,도봉구,휘발유(무연),사업용,69,0,0,0,69
2014,도봉구,휘발유(유연),비사업용,4,0,0,0,4
2014,노원구,CNG,비사업용,39,3,11,0,53
2014,노원구,CNG,사업용,6,611,1,0,618
2014,노원구,경유,비사업용,31178,4612,10381,52,46223
2014,노원구,경유,사업용,92,202,1595,172,2061
2014,노원구,기타연료,비사업용,2,28,73,0,103
2014,노원구,기타연료,사업용,0,0,11,0,11
2014,노원구,엘피지,비사업용,13123,1915,1674,1,16713
2014,노원구,엘피지,사업용,6099,0,428,0,6527
2014,노원구,전기,비사업용,5,0,0,0,5
2014,노원구,하이브리드(CNG+전기),사업용,0,5,0,0,5
2014,노원구,하이브리드(LPG+전기),비사업용,102,0,0,0,102
2014,노원구,하이브리드(휘발유+전기),비사업용,841,0,0,0,841
2014,노원구,하이브리드(휘발유+전기),사업용,1,0,0,0,1
2014,노원구,휘발유,비사업용,30796,8,31,0,30835
2014,노원구,휘발유,사업용,34,0,0,0,34
2014,노원구,휘발유(무연),비사업용,48664,37,22,0,48723
2014,노원구,휘발유(무연),사업용,76,0,0,0,76
2014,노원구,휘발유(유연),비사업용,4,0,0,0,4
2014,은평구,CNG,비사업용,20,2,14,0,36
2014,은평구,CNG,사업용,12,679,0,0,691
2014,은평구,경유,비사업용,24319,4252,10489,36,39096
2014,은평구,경유,사업용,28,61,1632,134,1855
2014,은평구,기타연료,비사업용,4,12,59,1,76
2014,은평구,기타연료,사업용,0,0,3,0,3
2014,은평구,엘피지,비사업용,9507,1754,1565,0,12826
2014,은평구,엘피지,사업용,3953,0,352,0,4305
2014,은평구,전기,비사업용,2,0,0,0,2
2014,은평구,태양열,비사업용,1,0,0,0,1
2014,은평구,하이브리드(CNG+전기),사업용,0,1,0,0,1
2014,은평구,하이브리드(LPG+전기),비사업용,90,0,0,0,90
2014,은평구,하이브리드(휘발유+전기),비사업용,655,0,0,0,655
2014,은평구,휘발유,비사업용,25572,17,28,0,25617
2014,은평구,휘발유,사업용,17,0,0,0,17
2014,은평구,휘발유(무연),비사업용,38763,40,23,0,38826
2014,은평구,휘발유(무연),사업용,29,0,0,0,29
2014,서대문구,CNG,비사업용,13,6,15,0,34
2014,서대문구,CNG,사업용,6,270,0,0,276
2014,서대문구,경유,비사업용,15423,2845,6148,43,24459
2014,서대문구,경유,사업용,18,97,1350,77,1542
2014,서대문구,기타연료,비사업용,2,13,27,0,42
2014,서대문구,기타연료,사업용,0,0,16,0,16
2014,서대문구,엘피지,비사업용,5429,933,873,0,7235
2014,서대문구,엘피지,사업용,2543,1,189,0,2733
2014,서대문구,전기,비사업용,6,0,0,0,6
2014,서대문구,하이브리드(LPG+전기),비사업용,64,0,0,0,64
2014,서대문구,하이브리드(경유+전기),비사업용,1,0,0,0,1
2014,서대문구,하이브리드(휘발유+전기),비사업용,512,0,0,0,512
2014,서대문구,휘발유,비사업용,17678,16,29,1,17724
2014,서대문구,휘발유,사업용,19,2,0,0,21
2014,서대문구,휘발유(무연),비사업용,24835,27,18,0,24880
2014,서대문구,휘발유(무연),사업용,36,0,0,0,36
2014,서대문구,휘발유(유연),비사업용,1,0,0,0,1
2014,마포구,CNG,비사업용,25,3,28,0,56
2014,마포구,CNG,사업용,3,294,0,0,297
2014,마포구,경유,비사업용,22076,3644,9476,105,35301
2014,마포구,경유,사업용,271,568,2193,179,3211
2014,마포구,기타연료,비사업용,2,19,61,1,83
2014,마포구,기타연료,사업용,0,0,38,0,38
2014,마포구,엘피지,비사업용,6555,1177,1235,1,8968
2014,마포구,엘피지,사업용,2779,1,229,0,3009
2014,마포구,전기,비사업용,15,0,0,0,15
2014,마포구,전기,사업용,249,0,0,0,249
2014,마포구,하이브리드(LPG+전기),비사업용,59,0,0,0,59
2014,마포구,하이브리드(휘발유+전기),비사업용,787,0,0,0,787
2014,마포구,하이브리드(휘발유+전기),사업용,7,0,0,0,7
2014,마포구,휘발유,비사업용,26983,20,48,5,27056
2014,마포구,휘발유,사업용,196,0,0,0,196
2014,마포구,휘발유(무연),비사업용,34191,46,41,0,34278
2014,마포구,휘발유(무연),사업용,1260,0,0,0,1260
2014,양천구,CNG,비사업용,27,2,14,0,43
2014,양천구,CNG,사업용,19,662,0,0,681
2014,양천구,경유,비사업용,27850,4141,12007,102,44100
2014,양천구,경유,사업용,38,443,2428,334,3243
2014,양천구,기타연료,비사업용,2,25,71,1,99
2014,양천구,기타연료,사업용,0,0,48,0,48
2014,양천구,엘피지,비사업용,10283,1766,1729,1,13779
2014,양천구,엘피지,사업용,4756,0,314,0,5070
2014,양천구,전기,비사업용,2,0,0,0,2
2014,양천구,하이브리드(LPG+전기),비사업용,117,0,0,0,117
2014,양천구,하이브리드(휘발유+전기),비사업용,891,0,0,0,891
2014,양천구,하이브리드(휘발유+전기),사업용,1,0,0,0,1
2014,양천구,휘발유,비사업용,34192,17,22,0,34231
2014,양천구,휘발유,사업용,36,10,0,0,46
2014,양천구,휘발유(무연),비사업용,44985,41,41,0,45067
2014,양천구,휘발유(무연),사업용,36,0,1,0,37
2014,양천구,휘발유(유연),비사업용,2,0,0,0,2
2014,강서구,CNG,비사업용,46,8,19,0,73
2014,강서구,CNG,사업용,47,422,0,0,469
2014,강서구,경유,비사업용,35202,5614,15932,101,56849
2014,강서구,경유,사업용,451,976,2412,199,4038
2014,강서구,기타연료,비사업용,4,12,98,4,118
2014,강서구,기타연료,사업용,0,0,17,0,17
2014,강서구,엘피지,비사업용,14224,2268,2335,4,18831
2014,강서구,엘피지,사업용,7533,0,398,1,7932
2014,강서구,전기,비사업용,6,0,0,0,6
2014,강서구,전기,사업용,35,0,0,0,35
2014,강서구,하이브리드(LPG+전기),비사업용,150,0,0,0,150
2014,강서구,하이브리드(LPG+전기),사업용,1,0,0,0,1
2014,강서구,하이브리드(경유+전기),비사업용,1,0,0,0,1
2014,강서구,하이브리드(휘발유+전기),비사업용,1077,0,0,0,1077
2014,강서구,하이브리드(휘발유+전기),사업용,849,0,0,0,849
2014,강서구,휘발유,비사업용,38844,26,29,0,38899
2014,강서구,휘발유,사업용,180,2,0,0,182
2014,강서구,휘발유(무연),비사업용,54971,46,38,1,55056
2014,강서구,휘발유(무연),사업용,717,1,0,0,718
2014,강서구,휘발유(유연),비사업용,2,0,0,0,2
2014,구로구,CNG,비사업용,28,0,15,0,43
2014,구로구,CNG,사업용,20,342,0,0,362
2014,구로구,경유,비사업용,27145,4817,13424,86,45472
2014,구로구,경유,사업용,808,807,2288,127,4030
2014,구로구,기타연료,비사업용,2,24,62,2,90
2014,구로구,기타연료,사업용,0,0,21,0,21
2014,구로구,엘피지,비사업용,9556,1559,1544,1,12660
2014,구로구,엘피지,사업용,5847,9,364,0,6220
2014,구로구,전기,비사업용,4,0,0,0,4
2014,구로구,하이브리드(LPG+전기),비사업용,97,0,0,0,97
2014,구로구,하이브리드(LPG+전기),사업용,3,0,0,0,3
2014,구로구,하이브리드(휘발유+전기),비사업용,803,0,0,0,803
2014,구로구,하이브리드(휘발유+전기),사업용,14,0,0,0,14
2014,구로구,휘발유,비사업용,26683,10,30,0,26723
2014,구로구,휘발유,사업용,303,1,0,0,304
2014,구로구,휘발유(무연),비사업용,38786,22,26,0,38834
2014,구로구,휘발유(무연),사업용,1516,2,0,0,1518
2014,구로구,휘발유(유연),비사업용,1,0,0,0,1
2014,금천구,CNG,비사업용,18,1,11,0,30
2014,금천구,CNG,사업용,5,393,0,0,398
2014,금천구,경유,비사업용,15333,3247,9594,28,28202
2014,금천구,경유,사업용,197,76,1999,58,2330
2014,금천구,기타연료,비사업용,1,7,29,0,37
2014,금천구,기타연료,사업용,0,0,12,0,12
2014,금천구,엘피지,비사업용,5171,1034,1155,3,7363
2014,금천구,엘피지,사업용,4407,0,208,0,4615
2014,금천구,전기,비사업용,4,0,0,0,4
2014,금천구,하이브리드(LPG+전기),비사업용,68,0,0,0,68
2014,금천구,하이브리드(LPG+전기),사업용,4,0,0,0,4
2014,금천구,하이브리드(경유+전기),비사업용,0,1,0,0,1
2014,금천구,하이브리드(휘발유+전기),비사업용,424,0,0,0,424
2014,금천구,하이브리드(휘발유+전기),사업용,11,0,0,0,11
2014,금천구,휘발유,비사업용,14428,9,31,0,14468
2014,금천구,휘발유,사업용,21,0,0,0,21
2014,금천구,휘발유(무연),비사업용,22180,14,20,0,22214
2014,금천구,휘발유(무연),사업용,619,0,0,0,619
2014,금천구,휘발유(유연),비사업용,2,0,0,0,2
2014,영등포구,CNG,비사업용,17,2,30,0,49
2014,영등포구,CNG,사업용,12,86,0,0,98
2014,영등포구,경유,비사업용,27712,4694,15498,252,48156
2014,영등포구,경유,사업용,322,373,3770,302,4767
2014,영등포구,기타연료,비사업용,4,24,80,7,115
2014,영등포구,기타연료,사업용,0,0,174,3,177
2014,영등포구,엘피지,비사업용,7774,1372,1594,5,10745
2014,영등포구,엘피지,사업용,3224,1,340,3,3568
2014,영등포구,전기,비사업용,19,0,0,0,19
2014,영등포구,하이브리드(LPG+전기),비사업용,128,0,0,0,128
2014,영등포구,하이브리드(경유+전기),비사업용,1,0,0,0,1
2014,영등포구,하이브리드(휘발유+전기),비사업용,1210,0,0,0,1210
2014,영등포구,하이브리드(휘발유+전기),사업용,157,0,0,0,157
2014,영등포구,휘발유,비사업용,30622,23,50,0,30695
2014,영등포구,휘발유,사업용,56,0,0,0,56
2014,영등포구,휘발유(무연),비사업용,39187,46,41,0,39274
2014,영등포구,휘발유(무연),사업용,514,0,0,0,514
2014,영등포구,휘발유(유연),비사업용,2,0,0,0,2
2014,동작구,CNG,비사업용,15,0,10,0,25
2014,동작구,CNG,사업용,2,75,0,0,77
2014,동작구,경유,비사업용,20362,2996,7113,91,30562
2014,동작구,경유,사업용,8,38,1059,179,1284
2014,동작구,기타연료,비사업용,1,10,41,0,52
2014,동작구,기타연료,사업용,0,0,8,0,8
2014,동작구,엘피지,비사업용,7221,1141,1062,1,9425
2014,동작구,엘피지,사업용,1213,0,187,0,1400
2014,동작구,전기,비사업용,6,0,0,0,6
2014,동작구,하이브리드(LPG+전기),비사업용,109,0,0,0,109
2014,동작구,하이브리드(휘발유+전기),비사업용,787,0,0,0,787
2014,동작구,휘발유,비사업용,24782,10,15,0,24807
2014,동작구,휘발유(무연),비사업용,32947,18,28,0,32993
2014,동작구,휘발유(유연),비사업용,1,0,0,0,1
2014,관악구,CNG,비사업용,19,0,24,1,44
2014,관악구,CNG,사업용,8,233,0,0,241
2014,관악구,경유,비사업용,23387,4112,9743,39,37281
2014,관악구,경유,사업용,166,76,1630,131,2003
2014,관악구,기타연료,비사업용,0,11,48,1,60
2014,관악구,기타연료,사업용,0,0,6,0,6
2014,관악구,엘피지,비사업용,9294,1629,1539,0,12462
2014,관악구,엘피지,사업용,2972,0,321,0,3293
2014,관악구,전기,비사업용,5,0,0,0,5
2014,관악구,하이브리드(LPG+전기),비사업용,114,0,0,0,114
2014,관악구,하이브리드(경유+전기),비사업용,1,0,0,0,1
2014,관악구,하이브리드(휘발유+전기),비사업용,797,0,0,0,797
2014,관악구,하이브리드(휘발유+전기),사업용,2,0,0,0,2
2014,관악구,휘발유,비사업용,24892,12,32,0,24936
2014,관악구,휘발유,사업용,35,0,0,0,35
2014,관악구,휘발유(무연),비사업용,37460,28,31,0,37519
2014,관악구,휘발유(무연),사업용,122,0,0,0,122
2014,관악구,휘발유(유연),비사업용,1,0,0,0,1
2014,서초구,CNG,비사업용,38,2,27,1,68
2014,서초구,CNG,사업용,5,473,0,0,478
2014,서초구,경유,비사업용,30813,4322,11446,129,46710
2014,서초구,경유,사업용,1124,488,4676,165,6453
2014,서초구,기타연료,비사업용,8,52,123,4,187
2014,서초구,기타연료,사업용,0,0,139,4,143
2014,서초구,엘피지,비사업용,6189,1230,1198,1,8618
2014,서초구,엘피지,사업용,2680,2,110,0,2792
2014,서초구,전기,비사업용,20,0,0,0,20
2014,서초구,하이브리드(LPG+전기),비사업용,131,0,0,0,131
2014,서초구,하이브리드(경유+전기),비사업용,1,0,0,0,1
2014,서초구,하이브리드(경유+전기),사업용,1,0,0,0,1
2014,서초구,하이브리드(휘발유+전기),비사업용,3298,0,0,0,3298
2014,서초구,하이브리드(휘발유+전기),사업용,28,0,0,0,28
2014,서초구,휘발유,비사업용,55722,57,67,1,55847
2014,서초구,휘발유,사업용,401,3,0,0,404
2014,서초구,휘발유(무연),비사업용,53055,65,48,1,53169
2014,서초구,휘발유(무연),사업용,979,0,0,0,979
2014,서초구,휘발유(유연),비사업용,4,0,0,0,4
2014,강남구,CNG,비사업용,54,2,35,0,91
2014,강남구,CNG,사업용,14,209,0,0,223
2014,강남구,경유,비사업용,40381,5380,14604,130,60495
2014,강남구,경유,사업용,2827,1031,2015,157,6030
2014,강남구,기타연료,비사업용,14,45,116,7,182
2014,강남구,기타연료,사업용,0,1,204,0,205
2014,강남구,엘피지,비사업용,8631,1646,1596,2,11875
2014,강남구,엘피지,사업용,7030,14,129,0,7173
2014,강남구,전기,비사업용,52,0,0,0,52
2014,강남구,전기,사업용,41,0,0,0,41
2014,강남구,태양열,비사업용,1,0,0,0,1
2014,강남구,하이브리드(LPG+전기),비사업용,147,0,0,0,147
2014,강남구,하이브리드(LPG+전기),사업용,54,0,0,0,54
2014,강남구,하이브리드(경유+전기),비사업용,2,0,0,0,2
2014,강남구,하이브리드(휘발유+전기),비사업용,3307,0,0,0,3307
2014,강남구,하이브리드(휘발유+전기),사업용,466,0,0,0,466
2014,강남구,휘발유,비사업용,74135,67,102,3,74307
2014,강남구,휘발유,사업용,932,8,0,0,940
2014,강남구,휘발유(무연),비사업용,68841,99,97,2,69039
2014,강남구,휘발유(무연),사업용,6051,0,0,0,6051
2014,강남구,휘발유(유연),비사업용,12,0,0,0,12
2014,송파구,CNG,비사업용,63,2,49,0,114
2014,송파구,CNG,사업용,115,837,0,0,952
2014,송파구,경유,비사업용,41363,5367,17265,72,64067
2014,송파구,경유,사업용,217,756,3083,164,4220
2014,송파구,기타연료,비사업용,5,42,142,3,192
2014,송파구,기타연료,사업용,0,0,18,0,18
2014,송파구,엘피지,비사업용,11739,2054,2291,2,16086
2014,송파구,엘피지,사업용,4871,3,493,0,5367
2014,송파구,전기,비사업용,9,0,0,0,9
2014,송파구,하이브리드(CNG+전기),사업용,0,4,0,0,4
2014,송파구,하이브리드(LPG+전기),비사업용,179,0,0,0,179
2014,송파구,하이브리드(LPG+전기),사업용,1,0,0,0,1
2014,송파구,하이브리드(휘발유+전기),비사업용,1617,0,0,0,1617
2014,송파구,하이브리드(휘발유+전기),사업용,7,0,0,0,7
2014,송파구,휘발유,비사업용,56500,22,74,1,56597
2014,송파구,휘발유,사업용,97,2,0,0,99
2014,송파구,휘발유(무연),비사업용,66124,49,42,0,66215
2014,송파구,휘발유(무연),사업용,242,0,0,0,242
2014,송파구,휘발유(유연),비사업용,4,0,0,0,4
2014,강동구,CNG,비사업용,30,0,21,0,51
2014,강동구,CNG,사업용,67,197,0,0,264
2014,강동구,경유,비사업용,27305,4044,12412,37,43798
2014,강동구,경유,사업용,141,489,1813,197,2640
2014,강동구,기타연료,비사업용,6,45,66,3,120
2014,강동구,기타연료,사업용,0,0,27,0,27
2014,강동구,엘피지,비사업용,10803,1770,1833,2,14408
2014,강동구,엘피지,사업용,4939,1,404,0,5344
2014,강동구,전기,비사업용,4,0,0,0,4
2014,강동구,하이브리드(CNG+전기),사업용,0,2,0,0,2
2014,강동구,하이브리드(LPG+전기),비사업용,107,0,0,0,107
2014,강동구,하이브리드(휘발유+전기),비사업용,907,0,0,0,907
2014,강동구,하이브리드(휘발유+전기),사업용,5,0,0,0,5
2014,강동구,휘발유,비사업용,29710,26,37,0,29773
2014,강동구,휘발유,사업용,49,0,0,0,49
2014,강동구,휘발유(무연),비사업용,42132,30,33,0,42195
2014,강동구,휘발유(무연),사업용,222,2,0,0,224
2014,강동구,휘발유(유연),비사업용,2,0,0,0,2
2015,합계 ,계,계,2560154,141927,347765,6742,3056588
2015,종로구,CNG,비사업용,8,2,20,0,30
2015,종로구,CNG,사업용,1,96,0,0,97
2015,종로구,경유,비사업용,9803,3331,4647,100,17881
2015,종로구,경유,사업용,39,239,499,75,852
2015,종로구,기타연료,비사업용,2,17,37,3,59
2015,종로구,기타연료,사업용,0,0,97,0,97
2015,종로구,엘피지,비사업용,2135,422,429,2,2988
2015,종로구,엘피지,사업용,239,0,131,0,370
2015,종로구,전기,비사업용,29,0,0,0,29
2015,종로구,하이브리드(LPG+전기),비사업용,40,0,0,0,40
2015,종로구,하이브리드(휘발유+전기),비사업용,598,0,0,0,598
2015,종로구,휘발유,비사업용,12117,25,40,1,12183
2015,종로구,휘발유,사업용,10,0,0,0,10
2015,종로구,휘발유(무연),비사업용,14389,41,14,1,14445
2015,종로구,휘발유(무연),사업용,135,0,0,0,135
2015,종로구,휘발유(유연),비사업용,3,0,0,0,3
2015,중구,CNG,비사업용,6,2,16,0,24
2015,중구,CNG,사업용,2,17,1,0,20
2015,중구,경유,비사업용,11515,2870,5204,78,19667
2015,중구,경유,사업용,313,345,1427,89,2174
2015,중구,기타연료,비사업용,4,16,35,5,60
2015,중구,기타연료,사업용,0,0,74,0,74
2015,중구,엘피지,비사업용,1834,492,525,1,2852
2015,중구,엘피지,사업용,793,2,74,0,869
2015,중구,전기,비사업용,52,1,0,0,53
2015,중구,전기,사업용,95,0,0,0,95
2015,중구,하이브리드(LPG+전기),비사업용,33,0,0,0,33
2015,중구,하이브리드(경유+전기),비사업용,6,0,0,0,6
2015,중구,하이브리드(휘발유+전기),비사업용,503,0,0,0,503
2015,중구,하이브리드(휘발유+전기),사업용,8,0,0,0,8
2015,중구,휘발유,비사업용,12457,22,28,2,12509
2015,중구,휘발유,사업용,257,5,0,0,262
2015,중구,휘발유(무연),비사업용,12941,20,31,0,12992
2015,중구,휘발유(무연),사업용,786,1,0,0,787
2015,용산구,CNG,비사업용,9,0,24,1,34
2015,용산구,CNG,사업용,1,8,0,0,9
2015,용산구,경유,비사업용,15089,2332,5812,83,23316
2015,용산구,경유,사업용,101,50,785,40,976
2015,용산구,기타연료,비사업용,468,24,67,5,564
2015,용산구,기타연료,사업용,0,0,3,0,3
2015,용산구,엘피지,비사업용,3256,656,643,0,4555
2015,용산구,엘피지,사업용,812,0,93,0,905
2015,용산구,전기,비사업용,19,0,0,0,19
2015,용산구,전기,사업용,32,0,0,0,32
2015,용산구,하이브리드(LPG+전기),비사업용,53,0,0,0,53
2015,용산구,하이브리드(경유+전기),비사업용,1,0,0,0,1
2015,용산구,하이브리드(휘발유+전기),비사업용,785,0,0,0,785
2015,용산구,하이브리드(휘발유+전기),사업용,2,0,0,0,2
2015,용산구,휘발유,비사업용,22208,20,47,0,22275
2015,용산구,휘발유,사업용,36,0,0,0,36
2015,용산구,휘발유(무연),비사업용,22349,38,26,0,22413
2015,용산구,휘발유(무연),사업용,97,0,0,0,97
2015,용산구,휘발유(유연),비사업용,3,0,0,0,3
2015,성동구,CNG,비사업용,10,4,16,0,30
2015,성동구,CNG,사업용,2,162,0,0,164
2015,성동구,경유,비사업용,20800,2716,8520,63,32099
2015,성동구,경유,사업용,353,372,1302,104,2131
2015,성동구,기타연료,비사업용,4,25,54,1,84
2015,성동구,기타연료,사업용,0,0,8,0,8
2015,성동구,엘피지,비사업용,5268,759,1091,0,7118
2015,성동구,엘피지,사업용,2805,4,308,0,3117
2015,성동구,전기,비사업용,28,0,0,0,28
2015,성동구,전기,사업용,6,0,0,0,6
2015,성동구,하이브리드(LPG+전기),비사업용,93,0,0,0,93
2015,성동구,하이브리드(LPG+전기),사업용,2,0,0,0,2
2015,성동구,하이브리드(휘발유+전기),비사업용,858,0,0,0,858
2015,성동구,하이브리드(휘발유+전기),사업용,26,0,0,0,26
2015,성동구,휘발유,비사업용,21437,8,25,0,21470
2015,성동구,휘발유,사업용,268,1,0,0,269
2015,성동구,휘발유(무연),비사업용,26308,19,5,0,26332
2015,성동구,휘발유(무연),사업용,1932,0,0,0,1932
2015,광진구,CNG,비사업용,5,1,13,0,19
2015,광진구,CNG,사업용,1,357,0,0,358
2015,광진구,경유,비사업용,20762,2856,8777,19,32414
2015,광진구,경유,사업용,218,305,1422,178,2123
2015,광진구,기타연료,비사업용,1,30,58,1,90
2015,광진구,기타연료,사업용,0,0,6,0,6
2015,광진구,엘피지,비사업용,5714,995,1127,1,7837
2015,광진구,엘피지,사업용,2304,2,288,60,2654
2015,광진구,전기,비사업용,12,0,0,0,12
2015,광진구,하이브리드(LPG+전기),비사업용,76,0,0,0,76
2015,광진구,하이브리드(휘발유+전기),비사업용,763,0,0,0,763
2015,광진구,하이브리드(휘발유+전기),사업용,18,0,0,0,18
2015,광진구,휘발유,비사업용,21135,8,22,0,21165
2015,광진구,휘발유,사업용,69,0,0,0,69
2015,광진구,휘발유(무연),비사업용,28280,33,27,0,28340
2015,광진구,휘발유(무연),사업용,148,0,0,0,148
2015,동대문구,CNG,비사업용,16,1,21,0,38
2015,동대문구,CNG,사업용,0,21,0,0,21
2015,동대문구,경유,비사업용,21003,3466,9993,38,34500
2015,동대문구,경유,사업용,295,261,1923,152,2631
2015,동대문구,기타연료,비사업용,3,17,72,1,93
2015,동대문구,기타연료,사업용,0,0,7,0,7
2015,동대문구,엘피지,비사업용,6398,1023,1359,1,8781
2015,동대문구,엘피지,사업용,2484,34,447,0,2965
2015,동대문구,전기,비사업용,15,0,0,0,15
2015,동대문구,전기,사업용,1,0,0,0,1
2015,동대문구,하이브리드(LPG+전기),비사업용,68,0,0,0,68
2015,동대문구,하이브리드(경유+전기),사업용,1,0,0,0,1
2015,동대문구,하이브리드(휘발유+전기),비사업용,696,0,0,0,696
2015,동대문구,하이브리드(휘발유+전기),사업용,4,0,0,0,4
2015,동대문구,휘발유,비사업용,19315,9,32,0,19356
2015,동대문구,휘발유,사업용,78,0,0,0,78
2015,동대문구,휘발유(무연),비사업용,27065,30,27,0,27122
2015,동대문구,휘발유(무연),사업용,228,0,0,0,228
2015,동대문구,휘발유(유연),비사업용,2,0,0,0,2
2015,중랑구,CNG,비사업용,21,2,12,0,35
2015,중랑구,CNG,사업용,2,359,0,0,361
2015,중랑구,경유,비사업용,23318,3905,11284,71,38578
2015,중랑구,경유,사업용,113,152,2249,245,2759
2015,중랑구,기타연료,비사업용,2,18,73,2,95
2015,중랑구,기타연료,사업용,0,0,25,0,25
2015,중랑구,엘피지,비사업용,8377,1385,1635,0,11397
2015,중랑구,엘피지,사업용,5580,0,451,0,6031
2015,중랑구,전기,비사업용,9,0,0,0,9
2015,중랑구,전기,사업용,3,9,0,0,12
2015,중랑구,하이브리드(LPG+전기),비사업용,66,0,0,0,66
2015,중랑구,하이브리드(경유+전기),비사업용,1,0,0,0,1
2015,중랑구,하이브리드(휘발유+전기),비사업용,607,0,0,0,607
2015,중랑구,하이브리드(휘발유+전기),사업용,3,0,0,0,3
2015,중랑구,휘발유,비사업용,19403,9,26,0,19438
2015,중랑구,휘발유,사업용,24,0,0,0,24
2015,중랑구,휘발유(무연),비사업용,30379,30,28,1,30438
2015,중랑구,휘발유(무연),사업용,214,0,0,0,214
2015,중랑구,휘발유(유연),비사업용,1,0,0,0,1
2015,성북구,CNG,비사업용,20,2,8,0,30
2015,성북구,CNG,사업용,2,781,0,0,783
2015,성북구,경유,비사업용,26626,4025,8647,31,39329
2015,성북구,경유,사업용,36,306,1287,73,1702
2015,성북구,기타연료,비사업용,5,25,97,2,129
2015,성북구,엘피지,비사업용,7827,1181,1230,2,10240
2015,성북구,엘피지,사업용,2565,0,391,0,2956
2015,성북구,전기,비사업용,14,0,0,0,14
2015,성북구,하이브리드(LPG+전기),비사업용,80,0,0,0,80
2015,성북구,하이브리드(휘발유+전기),비사업용,982,0,0,0,982
2015,성북구,하이브리드(휘발유+전기),사업용,1,0,0,0,1
2015,성북구,휘발유,비사업용,24870,14,31,0,24915
2015,성북구,휘발유,사업용,8,0,0,0,8
2015,성북구,휘발유(무연),비사업용,35318,28,21,0,35367
2015,성북구,휘발유(무연),사업용,8,0,0,0,8
2015,강북구,CNG,비사업용,15,1,14,0,30
2015,강북구,CNG,사업용,2,690,1,0,693
2015,강북구,경유,비사업용,16213,2844,7085,49,26191
2015,강북구,경유,사업용,12,84,946,73,1115
2015,강북구,기타연료,비사업용,1,8,33,1,43
2015,강북구,엘피지,비사업용,6222,1089,1080,1,8392
2015,강북구,엘피지,사업용,2662,0,302,0,2964
2015,강북구,전기,비사업용,9,0,0,0,9
2015,강북구,전기,사업용,2,0,0,0,2
2015,강북구,하이브리드(LPG+전기),비사업용,50,0,0,0,50
2015,강북구,하이브리드(휘발유+전기),비사업용,442,0,0,0,442
2015,강북구,하이브리드(휘발유+전기),사업용,1,0,0,0,1
2015,강북구,휘발유,비사업용,13555,9,19,0,13583
2015,강북구,휘발유,사업용,20,0,0,0,20
2015,강북구,휘발유(무연),비사업용,22152,19,7,0,22178
2015,강북구,휘발유(무연),사업용,47,0,0,0,47
2015,도봉구,CNG,비사업용,15,3,10,0,28
2015,도봉구,CNG,사업용,10,350,0,0,360
2015,도봉구,경유,비사업용,20282,3073,8013,47,31415
2015,도봉구,경유,사업용,52,92,1339,135,1618
2015,도봉구,기타연료,비사업용,4,17,53,1,75
2015,도봉구,기타연료,사업용,0,0,6,0,6
2015,도봉구,엘피지,비사업용,7095,1087,1167,0,9349
2015,도봉구,엘피지,사업용,5274,0,382,0,5656
2015,도봉구,전기,비사업용,9,0,0,0,9
2015,도봉구,전기,사업용,5,0,0,0,5
2015,도봉구,하이브리드(CNG+전기),사업용,0,5,0,0,5
2015,도봉구,하이브리드(LPG+전기),비사업용,99,0,0,0,99
2015,도봉구,하이브리드(휘발유+전기),비사업용,646,0,0,0,646
2015,도봉구,하이브리드(휘발유+전기),사업용,2,0,0,0,2
2015,도봉구,휘발유,비사업용,17878,8,17,0,17903
2015,도봉구,휘발유,사업용,15,0,0,0,15
2015,도봉구,휘발유(무연),비사업용,28563,14,16,0,28593
2015,도봉구,휘발유(무연),사업용,64,0,0,0,64
2015,도봉구,휘발유(유연),비사업용,3,0,0,0,3
2015,노원구,CNG,비사업용,40,3,11,0,54
2015,노원구,CNG,사업용,2,598,1,0,601
2015,노원구,경유,비사업용,33982,4568,10545,57,49152
2015,노원구,경유,사업용,94,222,1663,218,2197
2015,노원구,기타연료,비사업용,2,33,96,0,131
2015,노원구,기타연료,사업용,0,0,12,0,12
2015,노원구,엘피지,비사업용,12491,1546,1496,1,15534
2015,노원구,엘피지,사업용,6265,0,403,0,6668
2015,노원구,전기,비사업용,13,0,0,0,13
2015,노원구,전기,사업용,1,0,0,0,1
2015,노원구,하이브리드(CNG+전기),사업용,0,18,0,0,18
2015,노원구,하이브리드(LPG+전기),비사업용,109,0,0,0,109
2015,노원구,하이브리드(휘발유+전기),비사업용,1114,0,0,0,1114
2015,노원구,하이브리드(휘발유+전기),사업용,3,0,0,0,3
2015,노원구,휘발유,비사업용,30850,7,33,0,30890
2015,노원구,휘발유,사업용,44,0,0,0,44
2015,노원구,휘발유(무연),비사업용,47841,36,21,0,47898
2015,노원구,휘발유(무연),사업용,203,0,0,0,203
2015,노원구,휘발유(유연),비사업용,3,0,0,0,3
2015,은평구,CNG,비사업용,17,2,14,0,33
2015,은평구,CNG,사업용,11,722,0,0,733
2015,은평구,경유,비사업용,26951,4143,10611,42,41747
2015,은평구,경유,사업용,39,64,1582,165,1850
2015,은평구,기타연료,비사업용,3,23,68,5,99
2015,은평구,기타연료,사업용,0,0,3,0,3
2015,은평구,엘피지,비사업용,9175,1421,1401,0,11997
2015,은평구,엘피지,사업용,3972,0,333,0,4305
2015,은평구,전기,비사업용,12,0,0,0,12
2015,은평구,전기,사업용,6,0,0,0,6
2015,은평구,태양열,비사업용,1,0,0,0,1
2015,은평구,하이브리드(CNG+전기),사업용,0,1,0,0,1
2015,은평구,하이브리드(LPG+전기),비사업용,100,0,0,0,100
2015,은평구,하이브리드(휘발유+전기),비사업용,879,0,0,0,879
2015,은평구,하이브리드(휘발유+전기),사업용,1,0,0,0,1
2015,은평구,휘발유,비사업용,25840,17,31,0,25888
2015,은평구,휘발유,사업용,12,0,0,0,12
2015,은평구,휘발유(무연),비사업용,38715,36,22,0,38773
2015,은평구,휘발유(무연),사업용,42,0,0,0,42
2015,서대문구,CNG,비사업용,10,6,15,0,31
2015,서대문구,CNG,사업용,4,274,0,0,278
2015,서대문구,경유,비사업용,17466,2768,6169,40,26443
2015,서대문구,경유,사업용,25,116,1608,91,1840
2015,서대문구,기타연료,비사업용,3,17,31,1,52
2015,서대문구,기타연료,사업용,0,0,31,0,31
2015,서대문구,엘피지,비사업용,5164,782,786,0,6732
2015,서대문구,엘피지,사업용,2608,0,180,0,2788
2015,서대문구,전기,비사업용,12,0,0,0,12
2015,서대문구,하이브리드(LPG+전기),비사업용,54,0,0,0,54
2015,서대문구,하이브리드(경유+전기),비사업용,1,0,0,0,1
2015,서대문구,하이브리드(휘발유+전기),비사업용,672,0,0,0,672
2015,서대문구,휘발유,비사업용,18041,15,29,0,18085
2015,서대문구,휘발유,사업용,29,1,0,0,30
2015,서대문구,휘발유(무연),비사업용,25174,27,20,0,25221
2015,서대문구,휘발유(무연),사업용,56,0,0,0,56
2015,서대문구,휘발유(유연),비사업용,1,0,0,0,1
2015,마포구,CNG,비사업용,26,3,29,0,58
2015,마포구,CNG,사업용,1,295,0,0,296
2015,마포구,경유,비사업용,24959,3507,9416,102,37984
2015,마포구,경유,사업용,371,514,2250,233,3368
2015,마포구,기타연료,비사업용,2,27,85,1,115
2015,마포구,기타연료,사업용,0,0,46,0,46
2015,마포구,엘피지,비사업용,6243,975,1129,1,8348
2015,마포구,엘피지,사업용,2729,2,207,0,2938
2015,마포구,전기,비사업용,32,0,0,0,32
2015,마포구,전기,사업용,278,0,0,0,278
2015,마포구,하이브리드(LPG+전기),비사업용,64,0,0,0,64
2015,마포구,하이브리드(휘발유+전기),비사업용,1105,0,0,0,1105
2015,마포구,하이브리드(휘발유+전기),사업용,2,0,0,0,2
2015,마포구,휘발유,비사업용,27228,15,47,5,27295
2015,마포구,휘발유,사업용,71,0,0,0,71
2015,마포구,휘발유(무연),비사업용,34331,38,38,0,34407
2015,마포구,휘발유(무연),사업용,508,0,0,0,508
2015,양천구,CNG,비사업용,33,2,14,0,49
2015,양천구,CNG,사업용,14,662,0,0,676
2015,양천구,경유,비사업용,31042,4125,12235,106,47508
2015,양천구,경유,사업용,52,529,2360,367,3308
2015,양천구,기타연료,비사업용,2,27,90,3,122
2015,양천구,기타연료,사업용,0,0,45,0,45
2015,양천구,엘피지,비사업용,9791,1400,1543,0,12734
2015,양천구,엘피지,사업용,4768,0,290,0,5058
2015,양천구,전기,비사업용,17,0,0,0,17
2015,양천구,전기,사업용,46,0,0,0,46
2015,양천구,하이브리드(LPG+전기),비사업용,107,0,0,0,107
2015,양천구,하이브리드(경유+전기),비사업용,2,0,0,0,2
2015,양천구,하이브리드(휘발유+전기),비사업용,1176,0,0,0,1176
2015,양천구,하이브리드(휘발유+전기),사업용,2,0,0,0,2
2015,양천구,휘발유,비사업용,34151,12,23,0,34186
2015,양천구,휘발유,사업용,25,0,0,0,25
2015,양천구,휘발유(무연),비사업용,44517,36,40,0,44593
2015,양천구,휘발유(무연),사업용,64,0,0,0,64
2015,양천구,휘발유(유연),비사업용,3,0,0,0,3
2015,강서구,CNG,비사업용,48,8,18,0,74
2015,강서구,CNG,사업용,26,422,0,0,448
2015,강서구,경유,비사업용,39726,5534,16297,99,61656
2015,강서구,경유,사업용,346,990,2489,200,4025
2015,강서구,기타연료,비사업용,4,24,101,6,135
2015,강서구,기타연료,사업용,0,0,18,0,18
2015,강서구,엘피지,비사업용,13746,1846,2172,3,17767
2015,강서구,엘피지,사업용,7573,0,368,0,7941
2015,강서구,전기,비사업용,20,0,0,0,20
2015,강서구,전기,사업용,23,0,0,0,23
2015,강서구,하이브리드(LPG+전기),비사업용,140,0,0,0,140
2015,강서구,하이브리드(경유+전기),비사업용,1,0,0,0,1
2015,강서구,하이브리드(휘발유+전기),비사업용,1472,0,0,0,1472
2015,강서구,하이브리드(휘발유+전기),사업용,1411,0,0,0,1411
2015,강서구,휘발유,비사업용,39363,26,27,0,39416
2015,강서구,휘발유,사업용,124,0,0,0,124
2015,강서구,휘발유(무연),비사업용,55701,39,36,1,55777
2015,강서구,휘발유(무연),사업용,621,1,0,0,622
2015,강서구,휘발유(유연),비사업용,2,0,0,0,2
2015,구로구,CNG,비사업용,27,0,14,0,41
2015,구로구,CNG,사업용,11,343,0,0,354
2015,구로구,경유,비사업용,29899,4905,13659,99,48562
2015,구로구,경유,사업용,658,693,2225,139,3715
2015,구로구,기타연료,비사업용,0,26,101,2,129
2015,구로구,기타연료,사업용,0,0,22,0,22
2015,구로구,엘피지,비사업용,9138,1279,1387,1,11805
2015,구로구,엘피지,사업용,5349,5,345,0,5699
2015,구로구,전기,비사업용,14,0,0,0,14
2015,구로구,하이브리드(LPG+전기),비사업용,101,0,0,0,101
2015,구로구,하이브리드(휘발유+전기),비사업용,1059,0,0,0,1059
2015,구로구,하이브리드(휘발유+전기),사업용,64,0,0,0,64
2015,구로구,휘발유,비사업용,26859,13,32,0,26904
2015,구로구,휘발유,사업용,182,0,0,0,182
2015,구로구,휘발유(무연),비사업용,38603,22,28,0,38653
2015,구로구,휘발유(무연),사업용,965,2,0,0,967
2015,구로구,휘발유(유연),비사업용,1,0,0,0,1
2015,금천구,CNG,비사업용,18,1,11,0,30
2015,금천구,CNG,사업용,2,391,0,0,393
2015,금천구,경유,비사업용,17163,3339,9878,39,30419
2015,금천구,경유,사업용,210,77,2145,80,2512
2015,금천구,기타연료,비사업용,2,13,37,0,52
2015,금천구,기타연료,사업용,0,0,46,0,46
2015,금천구,엘피지,비사업용,4923,877,1027,2,6829
2015,금천구,엘피지,사업용,4158,0,202,0,4360
2015,금천구,전기,비사업용,10,0,2,0,12
2015,금천구,하이브리드(LPG+전기),비사업용,73,0,0,0,73
2015,금천구,하이브리드(경유+전기),비사업용,0,1,0,0,1
2015,금천구,하이브리드(휘발유+전기),비사업용,536,0,0,0,536
2015,금천구,하이브리드(휘발유+전기),사업용,15,0,0,0,15
2015,금천구,휘발유,비사업용,14411,14,30,0,14455
2015,금천구,휘발유,사업용,39,0,0,0,39
2015,금천구,휘발유(무연),비사업용,22372,13,20,0,22405
2015,금천구,휘발유(무연),사업용,507,0,0,0,507
2015,영등포구,CNG,비사업용,19,2,29,0,50
2015,영등포구,CNG,사업용,6,86,0,0,92
2015,영등포구,경유,비사업용,32678,4825,15327,364,53194
2015,영등포구,경유,사업용,458,340,3746,602,5146
2015,영등포구,기타연료,비사업용,4,28,94,6,132
2015,영등포구,기타연료,사업용,0,0,233,3,236
2015,영등포구,수소,비사업용,1,0,0,0,1
2015,영등포구,엘피지,비사업용,7336,1120,1427,5,9888
2015,영등포구,엘피지,사업용,3392,0,319,1,3712
2015,영등포구,전기,비사업용,33,0,0,0,33
2015,영등포구,전기,사업용,1,0,0,0,1
2015,영등포구,하이브리드(LPG+전기),비사업용,114,0,0,0,114
2015,영등포구,하이브리드(경유+전기),비사업용,2,0,0,0,2
2015,영등포구,하이브리드(휘발유+전기),비사업용,1583,0,0,0,1583
2015,영등포구,하이브리드(휘발유+전기),사업용,264,0,0,0,264
2015,영등포구,휘발유,비사업용,30864,25,48,0,30937
2015,영등포구,휘발유,사업용,63,0,0,0,63
2015,영등포구,휘발유(무연),비사업용,39623,40,43,0,39706
2015,영등포구,휘발유(무연),사업용,622,0,0,0,622
2015,영등포구,휘발유(유연),비사업용,2,0,0,0,2
2015,동작구,CNG,비사업용,18,0,10,0,28
2015,동작구,CNG,사업용,2,76,0,0,78
2015,동작구,경유,비사업용,22524,2996,7008,87,32615
2015,동작구,경유,사업용,6,38,1020,272,1336
2015,동작구,기타연료,비사업용,1,11,49,1,62
2015,동작구,기타연료,사업용,0,0,8,0,8
2015,동작구,엘피지,비사업용,6779,923,943,1,8646
2015,동작구,엘피지,사업용,1190,0,158,0,1348
2015,동작구,전기,비사업용,21,0,0,0,21
2015,동작구,전기,사업용,1,0,0,0,1
2015,동작구,하이브리드(LPG+전기),비사업용,97,0,0,0,97
2015,동작구,하이브리드(휘발유+전기),비사업용,991,0,0,0,991
2015,동작구,하이브리드(휘발유+전기),사업용,1,0,0,0,1
2015,동작구,휘발유,비사업용,24512,11,16,0,24539
2015,동작구,휘발유(무연),비사업용,32256,15,24,0,32295
2015,동작구,휘발유(유연),비사업용,1,0,0,0,1
2015,관악구,CNG,비사업용,18,1,15,1,35
2015,관악구,CNG,사업용,7,238,0,0,245
2015,관악구,경유,비사업용,26227,4056,9764,38,40085
2015,관악구,경유,사업용,179,54,1667,173,2073
2015,관악구,기타연료,비사업용,0,14,53,1,68
2015,관악구,기타연료,사업용,0,0,7,0,7
2015,관악구,엘피지,비사업용,8831,1335,1360,0,11526
2015,관악구,엘피지,사업용,2961,0,325,0,3286
2015,관악구,전기,비사업용,5,0,0,0,5
2015,관악구,전기,사업용,1,0,0,0,1
2015,관악구,하이브리드(LPG+전기),비사업용,128,0,0,0,128
2015,관악구,하이브리드(경유+전기),비사업용,1,0,0,0,1
2015,관악구,하이브리드(휘발유+전기),비사업용,1012,0,0,0,1012
2015,관악구,하이브리드(휘발유+전기),사업용,3,0,0,0,3
2015,관악구,휘발유,비사업용,24877,13,31,0,24921
2015,관악구,휘발유,사업용,22,0,0,0,22
2015,관악구,휘발유(무연),비사업용,37166,23,29,0,37218
2015,관악구,휘발유(무연),사업용,152,0,0,0,152
2015,관악구,휘발유(유연),비사업용,1,0,0,0,1
2015,서초구,CNG,비사업용,44,2,28,1,75
2015,서초구,CNG,사업용,2,488,0,0,490
2015,서초구,경유,비사업용,34885,4259,11297,145,50586
2015,서초구,경유,사업용,806,322,4903,166,6197
2015,서초구,기타연료,비사업용,12,60,164,4,240
2015,서초구,기타연료,사업용,0,0,123,3,126
2015,서초구,엘피지,비사업용,5978,1015,1082,1,8076
2015,서초구,엘피지,사업용,2277,3,97,0,2377
2015,서초구,전기,비사업용,51,0,0,0,51
2015,서초구,전기,사업용,1,0,0,0,1
2015,서초구,하이브리드(LPG+전기),비사업용,93,0,0,0,93
2015,서초구,하이브리드(경유+전기),비사업용,3,0,0,0,3
2015,서초구,하이브리드(휘발유+전기),비사업용,3339,0,0,0,3339
2015,서초구,하이브리드(휘발유+전기),사업용,35,0,0,0,35
2015,서초구,휘발유,비사업용,54030,45,58,1,54134
2015,서초구,휘발유,사업용,314,12,0,0,326
2015,서초구,휘발유(무연),비사업용,51772,53,44,1,51870
2015,서초구,휘발유(무연),사업용,826,0,0,0,826
2015,서초구,휘발유(유연),비사업용,2,0,0,0,2
2015,강남구,CNG,비사업용,53,2,35,0,90
2015,강남구,CNG,사업용,10,190,0,0,200
2015,강남구,경유,비사업용,45914,5254,16673,163,68004
2015,강남구,경유,사업용,3327,796,2094,171,6388
2015,강남구,기타연료,비사업용,12,68,126,12,218
2015,강남구,기타연료,사업용,0,0,252,0,252
2015,강남구,엘피지,비사업용,8036,1377,1508,2,10923
2015,강남구,엘피지,사업용,6268,9,124,0,6401
2015,강남구,전기,비사업용,102,0,0,0,102
2015,강남구,전기,사업용,53,0,0,0,53
2015,강남구,태양열,비사업용,1,0,0,0,1
2015,강남구,하이브리드(LPG+전기),비사업용,150,0,0,0,150
2015,강남구,하이브리드(LPG+전기),사업용,1,0,0,0,1
2015,강남구,하이브리드(경유+전기),비사업용,2,0,0,0,2
2015,강남구,하이브리드(경유+전기),사업용,1,0,0,0,1
2015,강남구,하이브리드(휘발유+전기),비사업용,4113,0,0,0,4113
2015,강남구,하이브리드(휘발유+전기),사업용,458,0,0,0,458
2015,강남구,휘발유,비사업용,72788,65,113,4,72970
2015,강남구,휘발유,사업용,633,6,0,0,639
2015,강남구,휘발유(무연),비사업용,67534,89,95,3,67721
2015,강남구,휘발유(무연),사업용,6089,0,0,0,6089
2015,강남구,휘발유(유연),비사업용,11,0,0,0,11
2015,송파구,CNG,비사업용,69,2,51,0,122
2015,송파구,CNG,사업용,54,862,0,0,916
2015,송파구,경유,비사업용,45860,5207,17150,81,68298
2015,송파구,경유,사업용,296,785,3229,200,4510
2015,송파구,기타연료,비사업용,4,45,176,5,230
2015,송파구,기타연료,사업용,0,0,20,0,20
2015,송파구,엘피지,비사업용,11012,1678,2122,5,14817
2015,송파구,엘피지,사업용,5199,3,484,0,5686
2015,송파구,전기,비사업용,23,0,0,0,23
2015,송파구,전기,사업용,4,0,0,0,4
2015,송파구,하이브리드(CNG+전기),사업용,0,4,0,0,4
2015,송파구,하이브리드(LPG+전기),비사업용,166,0,0,0,166
2015,송파구,하이브리드(LPG+전기),사업용,1,0,0,0,1
2015,송파구,하이브리드(경유+전기),비사업용,1,0,0,0,1
2015,송파구,하이브리드(휘발유+전기),비사업용,2175,0,0,0,2175
2015,송파구,하이브리드(휘발유+전기),사업용,6,0,0,0,6
2015,송파구,휘발유,비사업용,56079,22,73,1,56175
2015,송파구,휘발유,사업용,146,6,0,0,152
2015,송파구,휘발유(무연),비사업용,65249,39,39,0,65327
2015,송파구,휘발유(무연),사업용,302,0,0,0,302
2015,송파구,휘발유(유연),비사업용,7,0,0,0,7
2015,강동구,CNG,비사업용,29,0,21,0,50
2015,강동구,CNG,사업용,11,197,0,0,208
2015,강동구,경유,비사업용,29158,3888,12316,44,45406
2015,강동구,경유,사업용,129,505,1748,222,2604
2015,강동구,기타연료,비사업용,5,36,88,3,132
2015,강동구,기타연료,사업용,0,0,26,0,26
2015,강동구,엘피지,비사업용,9805,1432,1584,1,12822
2015,강동구,엘피지,사업용,5051,1,396,0,5448
2015,강동구,전기,비사업용,13,0,0,0,13
2015,강동구,전기,사업용,6,0,0,0,6
2015,강동구,하이브리드(CNG+전기),사업용,0,2,0,0,2
2015,강동구,하이브리드(LPG+전기),비사업용,92,0,0,0,92
2015,강동구,하이브리드(경유+전기),비사업용,1,0,0,0,1
2015,강동구,하이브리드(휘발유+전기),비사업용,1182,0,0,0,1182
2015,강동구,하이브리드(휘발유+전기),사업용,4,0,0,0,4
2015,강동구,휘발유,비사업용,28838,26,36,0,28900
2015,강동구,휘발유,사업용,40,0,0,0,40
2015,강동구,휘발유(무연),비사업용,40522,25,34,0,40581
2015,강동구,휘발유(무연),사업용,142,1,0,0,143
2015,강동구,휘발유(유연),비사업용,2,0,0,0,2
2016,합계,계,계,2598344,134309,343173,7181,3083007
2016,종로구,CNG,비사업용,5,2,20,0,27
2016,종로구,CNG,사업용,0,95,0,0,95
2016,종로구,경유,비사업용,10291,3300,4378,102,18071
2016,종로구,경유,사업용,57,232,512,65,866
2016,종로구,기타연료,비사업용,2,15,38,5,60
2016,종로구,기타연료,사업용,0,0,99,0,99
2016,종로구,수소,비사업용,2,0,0,0,2
2016,종로구,엘피지,비사업용,1936,360,408,1,2705
2016,종로구,엘피지,사업용,232,0,136,0,368
2016,종로구,전기,비사업용,36,0,1,0,37
2016,종로구,하이브리드(LPG+전기),비사업용,41,0,0,0,41
2016,종로구,하이브리드(경유+전기),비사업용,1,0,0,0,1
2016,종로구,하이브리드(휘발유+전기),비사업용,757,0,0,0,757
2016,종로구,하이브리드(휘발유+전기),사업용,3,0,0,0,3
2016,종로구,휘발유,비사업용,11727,33,41,1,11802
2016,종로구,휘발유,사업용,25,14,0,0,39
2016,종로구,휘발유(무연),비사업용,14246,36,17,1,14300
2016,종로구,휘발유(무연),사업용,185,0,0,0,185
2016,종로구,휘발유(유연),비사업용,13,0,0,0,13
2016,중구,CNG,비사업용,3,1,16,0,20
2016,중구,CNG,사업용,1,17,1,0,19
2016,중구,경유,비사업용,11882,2783,5100,65,19830
2016,중구,경유,사업용,212,386,1505,88,2191
2016,중구,기타연료,비사업용,4,17,53,10,84
2016,중구,기타연료,사업용,0,0,73,0,73
2016,중구,엘피지,비사업용,1666,419,532,1,2618
2016,중구,엘피지,사업용,745,9,76,0,830
2016,중구,전기,비사업용,63,1,0,0,64
2016,중구,전기,사업용,50,0,0,0,50
2016,중구,하이브리드(LPG+전기),비사업용,31,0,0,0,31
2016,중구,하이브리드(경유+전기),비사업용,1,0,0,0,1
2016,중구,하이브리드(휘발유+전기),비사업용,666,0,0,0,666
2016,중구,하이브리드(휘발유+전기),사업용,10,0,0,0,10
2016,중구,휘발유,비사업용,11925,19,22,2,11968
2016,중구,휘발유,사업용,195,8,0,0,203
2016,중구,휘발유(무연),비사업용,12453,16,31,0,12500
2016,중구,휘발유(무연),사업용,433,1,0,0,434
2016,중구,휘발유(유연),비사업용,12,0,0,0,12
2016,용산구,CNG,비사업용,6,0,24,1,31
2016,용산구,CNG,사업용,1,3,0,0,4
2016,용산구,경유,비사업용,16015,2251,5622,86,23974
2016,용산구,경유,사업용,90,54,781,41,966
2016,용산구,기타연료,비사업용,387,24,70,4,485
2016,용산구,기타연료,사업용,0,0,3,0,3
2016,용산구,엘피지,비사업용,3005,537,577,0,4119
2016,용산구,엘피지,사업용,835,4,89,0,928
2016,용산구,전기,비사업용,30,0,0,0,30
2016,용산구,전기,사업용,28,0,0,0,28
2016,용산구,하이브리드(LPG+전기),비사업용,47,0,0,0,47
2016,용산구,하이브리드(경유+전기),비사업용,1,0,0,0,1
2016,용산구,하이브리드(휘발유+전기),비사업용,1070,0,0,0,1070
2016,용산구,하이브리드(휘발유+전기),사업용,2,0,0,0,2
2016,용산구,휘발유,비사업용,21990,24,47,0,22061
2016,용산구,휘발유,사업용,21,0,0,0,21
2016,용산구,휘발유(무연),비사업용,21706,35,25,0,21766
2016,용산구,휘발유(무연),사업용,88,0,0,0,88
2016,용산구,휘발유(유연),비사업용,16,0,0,0,16
2016,성동구,CNG,비사업용,11,4,16,0,31
2016,성동구,CNG,사업용,1,162,0,0,163
2016,성동구,경유,비사업용,22857,2597,8511,75,34040
2016,성동구,경유,사업용,541,397,1304,111,2353
2016,성동구,기타연료,비사업용,5,33,56,1,95
2016,성동구,기타연료,사업용,0,0,8,0,8
2016,성동구,엘피지,비사업용,5080,612,996,0,6688
2016,성동구,엘피지,사업용,2949,12,302,0,3263
2016,성동구,전기,비사업용,33,0,0,0,33
2016,성동구,전기,사업용,4,0,0,0,4
2016,성동구,하이브리드(LPG+전기),비사업용,64,0,0,0,64
2016,성동구,하이브리드(LPG+전기),사업용,2,0,0,0,2
2016,성동구,하이브리드(휘발유+전기),비사업용,1208,0,0,0,1208
2016,성동구,하이브리드(휘발유+전기),사업용,20,0,0,0,20
2016,성동구,휘발유,비사업용,21687,9,26,0,21722
2016,성동구,휘발유,사업용,609,4,0,0,613
2016,성동구,휘발유(무연),비사업용,26473,14,3,0,26490
2016,성동구,휘발유(무연),사업용,2711,0,0,0,2711
2016,성동구,휘발유(유연),비사업용,21,0,0,0,21
2016,광진구,CNG,비사업용,11,1,13,0,25
2016,광진구,CNG,사업용,2,368,0,0,370
2016,광진구,경유,비사업용,22221,2807,8853,23,33904
2016,광진구,경유,사업용,286,365,1384,173,2208
2016,광진구,기타연료,비사업용,0,27,60,2,89
2016,광진구,기타연료,사업용,0,0,6,0,6
2016,광진구,엘피지,비사업용,5379,815,971,1,7166
2016,광진구,엘피지,사업용,2436,1,285,60,2782
2016,광진구,전기,비사업용,12,0,0,0,12
2016,광진구,하이브리드(LPG+전기),비사업용,69,0,0,0,69
2016,광진구,하이브리드(경유+전기),사업용,1,0,0,0,1
2016,광진구,하이브리드(휘발유+전기),비사업용,1066,0,0,0,1066
2016,광진구,하이브리드(휘발유+전기),사업용,6,0,0,0,6
2016,광진구,휘발유,비사업용,21228,9,25,0,21262
2016,광진구,휘발유,사업용,65,0,0,0,65
2016,광진구,휘발유(무연),비사업용,27659,30,25,0,27714
2016,광진구,휘발유(무연),사업용,264,0,0,0,264
2016,광진구,휘발유(유연),비사업용,36,0,0,0,36
2016,동대문구,CNG,비사업용,14,1,21,0,36
2016,동대문구,CNG,사업용,0,21,0,0,21
2016,동대문구,경유,비사업용,22374,3373,9891,53,35691
2016,동대문구,경유,사업용,269,195,1911,114,2489
2016,동대문구,기타연료,비사업용,3,27,98,1,129
2016,동대문구,기타연료,사업용,0,0,7,0,7
2016,동대문구,엘피지,비사업용,6038,862,1252,1,8153
2016,동대문구,엘피지,사업용,2490,0,418,0,2908
2016,동대문구,전기,비사업용,18,0,0,0,18
2016,동대문구,전기,사업용,4,0,0,0,4
2016,동대문구,하이브리드(LPG+전기),비사업용,63,0,0,0,63
2016,동대문구,하이브리드(경유+전기),사업용,1,0,0,0,1
2016,동대문구,하이브리드(휘발유+전기),비사업용,894,0,0,0,894
2016,동대문구,하이브리드(휘발유+전기),사업용,3,0,0,0,3
2016,동대문구,휘발유,비사업용,19572,8,31,0,19611
2016,동대문구,휘발유,사업용,76,0,0,0,76
2016,동대문구,휘발유(무연),비사업용,26907,27,29,0,26963
2016,동대문구,휘발유(무연),사업용,230,0,0,0,230
2016,동대문구,휘발유(유연),비사업용,36,0,0,0,36
2016,중랑구,CNG,비사업용,15,3,11,0,29
2016,중랑구,CNG,사업용,1,359,0,0,360
2016,중랑구,경유,비사업용,25198,3823,11460,74,40555
2016,중랑구,경유,사업용,153,170,2276,314,2913
2016,중랑구,기타연료,비사업용,2,25,72,3,102
2016,중랑구,기타연료,사업용,0,0,19,0,19
2016,중랑구,엘피지,비사업용,7893,1159,1470,0,10522
2016,중랑구,엘피지,사업용,5623,0,427,0,6050
2016,중랑구,전기,비사업용,17,0,0,0,17
2016,중랑구,전기,사업용,3,9,0,0,12
2016,중랑구,하이브리드(LPG+전기),비사업용,63,0,0,0,63
2016,중랑구,하이브리드(경유+전기),비사업용,1,0,0,0,1
2016,중랑구,하이브리드(휘발유+전기),비사업용,864,0,0,0,864
2016,중랑구,하이브리드(휘발유+전기),사업용,3,0,0,0,3
2016,중랑구,휘발유,비사업용,19668,12,27,0,19707
2016,중랑구,휘발유,사업용,26,0,0,0,26
2016,중랑구,휘발유(무연),비사업용,30420,26,29,1,30476
2016,중랑구,휘발유(무연),사업용,348,0,0,0,348
2016,중랑구,휘발유(유연),비사업용,31,0,0,0,31
2016,성북구,CNG,비사업용,19,2,8,0,29
2016,성북구,CNG,사업용,2,778,0,0,780
2016,성북구,경유,비사업용,27958,3875,8556,37,40426
2016,성북구,경유,사업용,46,334,1274,76,1730
2016,성북구,기타연료,비사업용,4,32,111,2,149
2016,성북구,엘피지,비사업용,7250,970,1090,2,9312
2016,성북구,엘피지,사업용,2596,2,370,0,2968
2016,성북구,전기,비사업용,24,0,0,0,24
2016,성북구,하이브리드(CNG+전기),사업용,0,3,0,0,3
2016,성북구,하이브리드(LPG+전기),비사업용,80,0,0,0,80
2016,성북구,하이브리드(휘발유+전기),비사업용,1303,0,0,0,1303
2016,성북구,하이브리드(휘발유+전기),사업용,2,0,0,0,2
2016,성북구,휘발유,비사업용,24756,12,32,0,24800
2016,성북구,휘발유,사업용,1,0,0,0,1
2016,성북구,휘발유(무연),비사업용,34739,22,21,0,34782
2016,성북구,휘발유(무연),사업용,24,0,0,0,24
2016,성북구,휘발유(유연),비사업용,33,0,0,0,33
2016,강북구,CNG,비사업용,10,1,14,0,25
2016,강북구,CNG,사업용,1,685,1,0,687
2016,강북구,경유,비사업용,17579,2773,7183,50,27585
2016,강북구,경유,사업용,18,68,924,81,1091
2016,강북구,기타연료,비사업용,1,7,36,0,44
2016,강북구,엘피지,비사업용,5858,902,956,0,7716
2016,강북구,엘피지,사업용,2661,0,277,0,2938
2016,강북구,전기,비사업용,12,0,0,0,12
2016,강북구,전기,사업용,3,0,0,0,3
2016,강북구,하이브리드(LPG+전기),비사업용,48,0,0,0,48
2016,강북구,하이브리드(휘발유+전기),비사업용,612,0,0,0,612
2016,강북구,하이브리드(휘발유+전기),사업용,6,0,0,0,6
2016,강북구,휘발유,비사업용,13891,10,21,0,13922
2016,강북구,휘발유,사업용,21,0,0,0,21
2016,강북구,휘발유(무연),비사업용,21953,20,9,0,21982
2016,강북구,휘발유(무연),사업용,120,0,0,0,120
2016,강북구,휘발유(유연),비사업용,32,0,0,0,32
2016,도봉구,CNG,비사업용,16,2,10,0,28
2016,도봉구,CNG,사업용,6,343,0,0,349
2016,도봉구,경유,비사업용,21660,3027,8070,45,32802
2016,도봉구,경유,사업용,52,85,1355,142,1634
2016,도봉구,기타연료,비사업용,3,22,61,0,86
2016,도봉구,기타연료,사업용,0,0,9,0,9
2016,도봉구,엘피지,비사업용,6788,912,1056,0,8756
2016,도봉구,엘피지,사업용,5219,0,358,0,5577
2016,도봉구,전기,비사업용,16,0,0,0,16
2016,도봉구,전기,사업용,6,0,0,0,6
2016,도봉구,하이브리드(CNG+전기),사업용,0,8,0,0,8
2016,도봉구,하이브리드(LPG+전기),비사업용,83,0,0,0,83
2016,도봉구,하이브리드(휘발유+전기),비사업용,903,0,0,0,903
2016,도봉구,하이브리드(휘발유+전기),사업용,1,0,0,0,1
2016,도봉구,휘발유,비사업용,18266,7,17,0,18290
2016,도봉구,휘발유,사업용,20,0,0,0,20
2016,도봉구,휘발유(무연),비사업용,28337,15,15,0,28367
2016,도봉구,휘발유(무연),사업용,95,0,0,0,95
2016,도봉구,휘발유(유연),비사업용,29,0,0,0,29
2016,노원구,CNG,비사업용,40,5,11,0,56
2016,노원구,CNG,사업용,2,586,1,0,589
2016,노원구,경유,비사업용,36079,4427,10496,60,51062
2016,노원구,경유,사업용,97,309,1670,244,2320
2016,노원구,기타연료,비사업용,2,42,118,2,164
2016,노원구,기타연료,사업용,0,0,12,0,12
2016,노원구,엘피지,비사업용,11794,1230,1333,1,14358
2016,노원구,엘피지,사업용,5999,1,388,0,6388
2016,노원구,전기,비사업용,22,0,0,0,22
2016,노원구,전기,사업용,3,0,0,0,3
2016,노원구,하이브리드(CNG+전기),사업용,0,31,0,0,31
2016,노원구,하이브리드(LPG+전기),비사업용,115,0,0,0,115
2016,노원구,하이브리드(휘발유+전기),비사업용,1576,0,0,0,1576
2016,노원구,하이브리드(휘발유+전기),사업용,4,0,0,0,4
2016,노원구,휘발유,비사업용,31184,7,31,0,31222
2016,노원구,휘발유,사업용,22,0,0,0,22
2016,노원구,휘발유(무연),비사업용,47477,31,16,0,47524
2016,노원구,휘발유(무연),사업용,178,0,0,0,178
2016,노원구,휘발유(유연),비사업용,50,0,0,0,50
2016,노원구,휘발유(유연),사업용,1,0,0,0,1
2016,은평구,CNG,비사업용,16,2,13,0,31
2016,은평구,CNG,사업용,8,722,0,0,730
2016,은평구,경유,비사업용,28684,4056,10602,48,43390
2016,은평구,경유,사업용,42,60,1610,179,1891
2016,은평구,기타연료,비사업용,3,26,78,7,114
2016,은평구,기타연료,사업용,0,0,3,0,3
2016,은평구,엘피지,비사업용,8779,1178,1246,0,11203
2016,은평구,엘피지,사업용,3865,0,303,0,4168
2016,은평구,전기,비사업용,25,0,0,0,25
2016,은평구,전기,사업용,5,0,0,0,5
2016,은평구,태양열,비사업용,1,0,0,0,1
2016,은평구,하이브리드(CNG+전기),사업용,0,1,0,0,1
2016,은평구,하이브리드(LPG+전기),비사업용,107,0,0,0,107
2016,은평구,하이브리드(휘발유+전기),비사업용,1235,0,0,0,1235
2016,은평구,하이브리드(휘발유+전기),사업용,1,0,0,0,1
2016,은평구,휘발유,비사업용,26234,15,35,0,26284
2016,은평구,휘발유,사업용,8,0,0,0,8
2016,은평구,휘발유(무연),비사업용,38311,28,22,0,38361
2016,은평구,휘발유(무연),사업용,53,0,0,0,53
2016,은평구,휘발유(유연),비사업용,36,0,0,0,36
2016,서대문구,CNG,비사업용,10,9,15,0,34
2016,서대문구,CNG,사업용,4,277,0,0,281
2016,서대문구,경유,비사업용,18958,2760,6135,48,27901
2016,서대문구,경유,사업용,70,114,1631,93,1908
2016,서대문구,기타연료,비사업용,3,22,45,5,75
2016,서대문구,기타연료,사업용,0,0,30,0,30
2016,서대문구,엘피지,비사업용,4943,633,700,0,6276
2016,서대문구,엘피지,사업용,2741,0,156,0,2897
2016,서대문구,전기,비사업용,13,0,0,0,13
2016,서대문구,하이브리드(CNG+전기),사업용,0,2,0,0,2
2016,서대문구,하이브리드(LPG+전기),비사업용,60,0,0,0,60
2016,서대문구,하이브리드(경유+전기),비사업용,1,0,0,0,1
2016,서대문구,하이브리드(휘발유+전기),비사업용,966,0,0,0,966
2016,서대문구,하이브리드(휘발유+전기),사업용,1,0,0,0,1
2016,서대문구,휘발유,비사업용,18479,13,31,0,18523
2016,서대문구,휘발유,사업용,32,0,0,0,32
2016,서대문구,휘발유(무연),비사업용,25188,22,19,0,25229
2016,서대문구,휘발유(무연),사업용,100,0,0,0,100
2016,서대문구,휘발유(유연),비사업용,29,0,0,0,29
2016,마포구,CNG,비사업용,29,3,29,0,61
2016,마포구,CNG,사업용,0,293,0,0,293
2016,마포구,경유,비사업용,26377,3343,9187,102,39009
2016,마포구,경유,사업용,415,405,2252,214,3286
2016,마포구,기타연료,비사업용,2,35,101,3,141
2016,마포구,기타연료,사업용,0,0,45,0,45
2016,마포구,엘피지,비사업용,5688,816,1018,1,7523
2016,마포구,엘피지,사업용,2735,1,186,0,2922
2016,마포구,전기,비사업용,50,0,0,0,50
2016,마포구,전기,사업용,277,0,0,0,277
2016,마포구,하이브리드(LPG+전기),비사업용,59,0,0,0,59
2016,마포구,하이브리드(휘발유+전기),비사업용,1507,0,0,0,1507
2016,마포구,하이브리드(휘발유+전기),사업용,2,0,0,0,2
2016,마포구,휘발유,비사업용,27282,16,49,4,27351
2016,마포구,휘발유,사업용,44,0,0,0,44
2016,마포구,휘발유(무연),비사업용,33700,38,39,0,33777
2016,마포구,휘발유(무연),사업용,692,0,0,0,692
2016,마포구,휘발유(유연),비사업용,32,0,0,0,32
2016,양천구,CNG,비사업용,37,2,14,0,53
2016,양천구,CNG,사업용,8,644,0,0,652
2016,양천구,경유,비사업용,33146,4003,12054,103,49306
2016,양천구,경유,사업용,63,387,2394,401,3245
2016,양천구,기타연료,비사업용,2,29,115,1,147
2016,양천구,기타연료,사업용,0,0,47,0,47
2016,양천구,엘피지,비사업용,9246,1116,1368,1,11731
2016,양천구,엘피지,사업용,4683,0,258,0,4941
2016,양천구,전기,비사업용,25,0,0,0,25
2016,양천구,전기,사업용,51,0,0,0,51
2016,양천구,하이브리드(LPG+전기),비사업용,101,0,0,0,101
2016,양천구,하이브리드(경유+전기),비사업용,2,0,0,0,2
2016,양천구,하이브리드(휘발유+전기),비사업용,1692,0,0,0,1692
2016,양천구,하이브리드(휘발유+전기),사업용,2,0,0,0,2
2016,양천구,휘발유,비사업용,34096,13,24,0,34133
2016,양천구,휘발유,사업용,22,0,0,0,22
2016,양천구,휘발유(무연),비사업용,43893,27,33,0,43953
2016,양천구,휘발유(무연),사업용,77,0,0,0,77
2016,양천구,휘발유(유연),비사업용,28,0,0,0,28
2016,강서구,CNG,비사업용,45,6,18,0,69
2016,강서구,CNG,사업용,17,423,0,0,440
2016,강서구,경유,비사업용,43010,5441,16392,113,64956
2016,강서구,경유,사업용,314,978,2510,207,4009
2016,강서구,기타연료,비사업용,4,28,135,4,171
2016,강서구,기타연료,사업용,0,0,19,0,19
2016,강서구,엘피지,비사업용,13040,1553,1950,2,16545
2016,강서구,엘피지,사업용,7863,0,351,1,8215
2016,강서구,전기,비사업용,37,0,0,0,37
2016,강서구,전기,사업용,4,0,0,0,4
2016,강서구,하이브리드(LPG+전기),비사업용,130,0,0,0,130
2016,강서구,하이브리드(경유+전기),비사업용,3,0,0,0,3
2016,강서구,하이브리드(휘발유+전기),비사업용,2082,0,0,0,2082
2016,강서구,하이브리드(휘발유+전기),사업용,1804,0,0,0,1804
2016,강서구,휘발유,비사업용,40544,23,30,0,40597
2016,강서구,휘발유,사업용,103,0,0,0,103
2016,강서구,휘발유(무연),비사업용,56247,34,36,1,56318
2016,강서구,휘발유(무연),사업용,594,1,0,0,595
2016,강서구,휘발유(유연),비사업용,67,0,0,0,67
2016,구로구,CNG,비사업용,22,0,11,0,33
2016,구로구,CNG,사업용,6,344,0,0,350
2016,구로구,경유,비사업용,32190,5139,13610,110,51049
2016,구로구,경유,사업용,951,417,2325,154,3847
2016,구로구,기타연료,비사업용,0,38,125,4,167
2016,구로구,기타연료,사업용,0,0,28,0,28
2016,구로구,엘피지,비사업용,8587,1037,1237,1,10862
2016,구로구,엘피지,사업용,5063,5,310,0,5378
2016,구로구,전기,비사업용,20,0,0,0,20
2016,구로구,하이브리드(LPG+전기),비사업용,100,0,0,0,100
2016,구로구,하이브리드(휘발유+전기),비사업용,1436,0,0,0,1436
2016,구로구,하이브리드(휘발유+전기),사업용,82,0,0,0,82
2016,구로구,휘발유,비사업용,26962,12,31,0,27005
2016,구로구,휘발유,사업용,133,0,0,0,133
2016,구로구,휘발유(무연),비사업용,38496,22,28,0,38546
2016,구로구,휘발유(무연),사업용,1593,0,0,0,1593
2016,구로구,휘발유(유연),비사업용,40,0,0,0,40
2016,구로구,휘발유(유연),사업용,24,0,0,0,24
2016,금천구,CNG,비사업용,22,1,7,0,30
2016,금천구,CNG,사업용,0,391,0,0,391
2016,금천구,경유,비사업용,19019,3469,10156,49,32693
2016,금천구,경유,사업용,195,97,2137,88,2517
2016,금천구,기타연료,비사업용,1,10,43,1,55
2016,금천구,기타연료,사업용,0,0,38,0,38
2016,금천구,수소,비사업용,1,0,0,0,1
2016,금천구,엘피지,비사업용,4720,725,936,3,6384
2016,금천구,엘피지,사업용,3623,3,196,0,3822
2016,금천구,전기,비사업용,12,0,3,0,15
2016,금천구,전기,사업용,52,0,0,0,52
2016,금천구,하이브리드(LPG+전기),비사업용,68,0,0,0,68
2016,금천구,하이브리드(경유+전기),비사업용,0,1,0,0,1
2016,금천구,하이브리드(휘발유+전기),비사업용,750,0,0,0,750
2016,금천구,하이브리드(휘발유+전기),사업용,13,0,0,0,13
2016,금천구,휘발유,비사업용,14674,11,28,0,14713
2016,금천구,휘발유,사업용,17,0,0,0,17
2016,금천구,휘발유(무연),비사업용,22697,13,19,0,22729
2016,금천구,휘발유(무연),사업용,373,0,0,0,373
2016,금천구,휘발유(유연),비사업용,21,0,0,0,21
2016,금천구,휘발유(유연),사업용,1,0,0,0,1
2016,영등포구,CNG,비사업용,21,2,29,0,52
2016,영등포구,CNG,사업용,4,95,0,0,99
2016,영등포구,경유,비사업용,34810,4838,14485,476,54609
2016,영등포구,경유,사업용,393,344,3891,639,5267
2016,영등포구,기타연료,비사업용,4,31,117,5,157
2016,영등포구,기타연료,사업용,0,0,225,2,227
2016,영등포구,수소,비사업용,2,0,0,0,2
2016,영등포구,엘피지,비사업용,6890,915,1298,3,9106
2016,영등포구,엘피지,사업용,3079,1,302,1,3383
2016,영등포구,전기,비사업용,76,0,0,0,76
2016,영등포구,전기,사업용,19,0,0,0,19
2016,영등포구,하이브리드(LPG+전기),비사업용,97,0,0,0,97
2016,영등포구,하이브리드(경유+전기),비사업용,3,0,0,0,3
2016,영등포구,하이브리드(휘발유+전기),비사업용,2046,0,0,0,2046
2016,영등포구,하이브리드(휘발유+전기),사업용,306,0,0,0,306
2016,영등포구,휘발유,비사업용,30652,22,52,0,30726
2016,영등포구,휘발유,사업용,31,0,0,0,31
2016,영등포구,휘발유(무연),비사업용,39423,34,41,0,39498
2016,영등포구,휘발유(무연),사업용,417,0,0,0,417
2016,영등포구,휘발유(유연),비사업용,58,0,0,0,58
2016,영등포구,휘발유(유연),사업용,1,0,0,0,1
2016,동작구,CNG,비사업용,18,0,9,0,27
2016,동작구,CNG,사업용,0,72,0,0,72
2016,동작구,경유,비사업용,24292,2939,7162,102,34495
2016,동작구,경유,사업용,4,46,1026,296,1372
2016,동작구,기타연료,비사업용,2,19,55,1,77
2016,동작구,기타연료,사업용,0,0,6,0,6
2016,동작구,엘피지,비사업용,6376,771,859,1,8007
2016,동작구,엘피지,사업용,1184,0,147,0,1331
2016,동작구,전기,비사업용,27,0,0,0,27
2016,동작구,전기,사업용,1,0,0,0,1
2016,동작구,하이브리드(LPG+전기),비사업용,87,0,0,0,87
2016,동작구,하이브리드(휘발유+전기),비사업용,1461,0,0,0,1461
2016,동작구,하이브리드(휘발유+전기),사업용,1,0,0,0,1
2016,동작구,휘발유,비사업용,24849,11,16,0,24876
2016,동작구,휘발유(무연),비사업용,32266,12,21,0,32299
2016,동작구,휘발유(무연),사업용,1,0,0,0,1
2016,동작구,휘발유(유연),비사업용,36,0,0,0,36
2016,관악구,CNG,비사업용,23,3,14,1,41
2016,관악구,CNG,사업용,5,241,0,0,246
2016,관악구,경유,비사업용,27965,4024,9866,45,41900
2016,관악구,경유,사업용,154,48,1568,173,1943
2016,관악구,기타연료,비사업용,0,21,69,2,92
2016,관악구,기타연료,사업용,0,0,8,0,8
2016,관악구,엘피지,비사업용,8236,1110,1216,1,10563
2016,관악구,엘피지,사업용,3072,0,307,0,3379
2016,관악구,전기,비사업용,9,0,0,0,9
2016,관악구,전기,사업용,1,0,0,0,1
2016,관악구,하이브리드(LPG+전기),비사업용,134,0,0,0,134
2016,관악구,하이브리드(경유+전기),비사업용,1,0,0,0,1
2016,관악구,하이브리드(휘발유+전기),비사업용,1412,0,0,0,1412
2016,관악구,하이브리드(휘발유+전기),사업용,2,0,0,0,2
2016,관악구,휘발유,비사업용,25204,12,29,0,25245
2016,관악구,휘발유,사업용,20,0,0,0,20
2016,관악구,휘발유(무연),비사업용,36772,19,29,0,36820
2016,관악구,휘발유(무연),사업용,162,0,0,0,162
2016,관악구,휘발유(유연),비사업용,61,0,0,0,61
2016,서초구,CNG,비사업용,36,2,28,1,67
2016,서초구,CNG,사업용,1,495,0,0,496
2016,서초구,경유,비사업용,37098,4077,11160,145,52480
2016,서초구,경유,사업용,884,303,4903,171,6261
2016,서초구,기타연료,비사업용,10,79,174,10,273
2016,서초구,기타연료,사업용,0,0,92,2,94
2016,서초구,엘피지,비사업용,5535,862,997,2,7396
2016,서초구,엘피지,사업용,2207,2,87,0,2296
2016,서초구,전기,비사업용,102,0,0,0,102
2016,서초구,전기,사업용,1,0,0,0,1
2016,서초구,하이브리드(LPG+전기),비사업용,92,0,0,0,92
2016,서초구,하이브리드(경유+전기),비사업용,2,0,0,0,2
2016,서초구,하이브리드(휘발유+전기),비사업용,4169,0,0,0,4169
2016,서초구,하이브리드(휘발유+전기),사업용,31,0,0,0,31
2016,서초구,휘발유,비사업용,53365,51,63,1,53480
2016,서초구,휘발유,사업용,211,21,0,0,232
2016,서초구,휘발유(무연),비사업용,51500,44,41,1,51586
2016,서초구,휘발유(무연),사업용,842,0,0,0,842
2016,서초구,휘발유(유연),비사업용,49,0,0,0,49
2016,강남구,CNG,비사업용,55,2,35,0,92
2016,강남구,CNG,사업용,4,192,0,0,196
2016,강남구,경유,비사업용,48989,4892,16376,155,70412
2016,강남구,경유,사업용,3496,697,1886,177,6256
2016,강남구,기타연료,비사업용,12,71,144,11,238
2016,강남구,기타연료,사업용,0,0,278,0,278
2016,강남구,수소,비사업용,7,0,0,0,7
2016,강남구,엘피지,비사업용,7306,1174,1331,2,9813
2016,강남구,엘피지,사업용,5538,4,108,0,5650
2016,강남구,전기,비사업용,94,0,0,0,94
2016,강남구,전기,사업용,124,0,0,0,124
2016,강남구,태양열,비사업용,1,0,0,0,1
2016,강남구,하이브리드(LPG+전기),비사업용,132,0,0,0,132
2016,강남구,하이브리드(LPG+전기),사업용,1,0,0,0,1
2016,강남구,하이브리드(경유+전기),비사업용,2,0,0,0,2
2016,강남구,하이브리드(휘발유+전기),비사업용,5429,0,0,0,5429
2016,강남구,하이브리드(휘발유+전기),사업용,577,0,0,0,577
2016,강남구,휘발유,비사업용,70790,58,105,5,70958
2016,강남구,휘발유,사업용,898,1,0,0,899
2016,강남구,휘발유(무연),비사업용,65291,77,93,2,65463
2016,강남구,휘발유(무연),사업용,5646,0,0,0,5646
2016,강남구,휘발유(유연),비사업용,78,0,0,0,78
2016,강남구,휘발유(유연),사업용,2,0,0,0,2
2016,송파구,CNG,비사업용,62,2,51,0,115
2016,송파구,CNG,사업용,18,853,0,0,871
2016,송파구,경유,비사업용,49244,4987,17038,82,71351
2016,송파구,경유,사업용,282,750,3548,208,4788
2016,송파구,기타연료,비사업용,3,55,203,7,268
2016,송파구,기타연료,사업용,0,0,22,0,22
2016,송파구,엘피지,비사업용,10426,1355,1903,1,13685
2016,송파구,엘피지,사업용,5425,3,476,0,5904
2016,송파구,전기,비사업용,41,0,0,0,41
2016,송파구,전기,사업용,4,0,0,0,4
2016,송파구,하이브리드(CNG+전기),사업용,0,4,0,0,4
2016,송파구,하이브리드(LPG+전기),비사업용,158,0,0,0,158
2016,송파구,하이브리드(경유+전기),비사업용,1,0,0,0,1
2016,송파구,하이브리드(휘발유+전기),비사업용,3114,0,0,0,3114
2016,송파구,하이브리드(휘발유+전기),사업용,7,0,0,0,7
2016,송파구,휘발유,비사업용,56062,26,72,0,56160
2016,송파구,휘발유,사업용,52,0,0,0,52
2016,송파구,휘발유(무연),비사업용,65576,29,40,0,65645
2016,송파구,휘발유(무연),사업용,238,0,0,0,238
2016,송파구,휘발유(유연),비사업용,86,0,0,0,86
2016,강동구,CNG,비사업용,35,0,21,0,56
2016,강동구,CNG,사업용,5,197,0,0,202
2016,강동구,경유,비사업용,30382,3720,12233,45,46380
2016,강동구,경유,사업용,134,390,1749,232,2505
2016,강동구,기타연료,비사업용,5,48,110,2,165
2016,강동구,기타연료,사업용,0,0,43,0,43
2016,강동구,엘피지,비사업용,9003,1123,1399,1,11526
2016,강동구,엘피지,사업용,5092,4,354,0,5450
2016,강동구,전기,비사업용,23,0,0,0,23
2016,강동구,전기,사업용,7,0,0,0,7
2016,강동구,하이브리드(CNG+전기),사업용,0,2,0,0,2
2016,강동구,하이브리드(LPG+전기),비사업용,89,0,0,0,89
2016,강동구,하이브리드(경유+전기),비사업용,1,0,0,0,1
2016,강동구,하이브리드(휘발유+전기),비사업용,1566,0,0,0,1566
2016,강동구,하이브리드(휘발유+전기),사업용,7,0,0,0,7
2016,강동구,휘발유,비사업용,28462,23,34,0,28519
2016,강동구,휘발유,사업용,18,0,0,0,18
2016,강동구,휘발유(무연),비사업용,39406,21,33,0,39460
2016,강동구,휘발유(무연),사업용,132,1,0,0,133
2016,강동구,휘발유(유연),비사업용,58,0,0,0,58
2017,합계,계,계,2641190,127564,339921,7581,3116256
2017,종로구,CNG,비사업용,6,2,18,0,26
2017,종로구,CNG,사업용,0,93,0,0,93
2017,종로구,경유,비사업용,11011,3367,4232,113,18723
2017,종로구,경유,사업용,51,217,524,64,856
2017,종로구,기타연료,비사업용,2,18,44,9,73
2017,종로구,기타연료,사업용,0,0,96,0,96
2017,종로구,수소,비사업용,2,0,0,0,2
2017,종로구,엘피지,비사업용,1880,297,375,1,2553
2017,종로구,엘피지,사업용,232,0,120,0,352
2017,종로구,전기,비사업용,73,0,2,0,75
2017,종로구,하이브리드(LPG+전기),비사업용,42,0,0,0,42
2017,종로구,하이브리드(경유+전기),비사업용,1,0,0,0,1
2017,종로구,하이브리드(휘발유+전기),비사업용,1007,0,0,0,1007
2017,종로구,하이브리드(휘발유+전기),사업용,5,0,0,0,5
2017,종로구,휘발유,비사업용,11892,32,43,1,11968
2017,종로구,휘발유,사업용,2,0,0,0,2
2017,종로구,휘발유(무연),비사업용,14721,29,15,1,14766
2017,종로구,휘발유(무연),사업용,178,0,0,0,178
2017,종로구,휘발유(유연),비사업용,10,0,0,0,10
2017,중구,CNG,비사업용,5,2,16,0,23
2017,중구,CNG,사업용,1,14,0,0,15
2017,중구,경유,비사업용,12047,2748,4874,80,19749
2017,중구,경유,사업용,397,303,1600,117,2417
2017,중구,기타연료,비사업용,5,18,77,15,115
2017,중구,기타연료,사업용,0,0,124,0,124
2017,중구,엘피지,비사업용,1580,382,483,1,2446
2017,중구,엘피지,사업용,717,2,67,0,786
2017,중구,전기,비사업용,106,1,2,0,109
2017,중구,전기,사업용,1,0,0,0,1
2017,중구,하이브리드(LPG+전기),비사업용,32,0,0,0,32
2017,중구,하이브리드(경유+전기),비사업용,2,0,0,0,2
2017,중구,하이브리드(휘발유+전기),비사업용,832,0,0,0,832
2017,중구,하이브리드(휘발유+전기),사업용,41,0,0,0,41
2017,중구,휘발유,비사업용,11634,18,24,2,11678
2017,중구,휘발유,사업용,164,5,0,0,169
2017,중구,휘발유(무연),비사업용,12530,15,27,0,12572
2017,중구,휘발유(무연),사업용,413,0,0,0,413
2017,중구,휘발유(유연),비사업용,16,0,0,0,16
2017,용산구,CNG,비사업용,7,1,25,1,34
2017,용산구,CNG,사업용,1,3,0,0,4
2017,용산구,경유,비사업용,17875,2154,5525,70,25624
2017,용산구,경유,사업용,89,63,912,41,1105
2017,용산구,기타연료,비사업용,314,30,76,7,427
2017,용산구,기타연료,사업용,0,0,3,0,3
2017,용산구,엘피지,비사업용,2828,464,519,0,3811
2017,용산구,엘피지,사업용,851,10,83,0,944
2017,용산구,전기,비사업용,67,0,0,0,67
2017,용산구,하이브리드(LPG+전기),비사업용,37,0,0,0,37
2017,용산구,하이브리드(경유+전기),비사업용,1,0,0,0,1
2017,용산구,하이브리드(휘발유+전기),비사업용,1446,0,0,0,1446
2017,용산구,하이브리드(휘발유+전기),사업용,2,0,0,0,2
2017,용산구,휘발유,비사업용,21962,24,51,0,22037
2017,용산구,휘발유,사업용,16,0,0,0,16
2017,용산구,휘발유(무연),비사업용,21597,34,27,0,21658
2017,용산구,휘발유(무연),사업용,217,0,0,0,217
2017,용산구,휘발유(유연),비사업용,25,0,0,0,25
2017,성동구,CNG,비사업용,16,4,17,0,37
2017,성동구,CNG,사업용,0,161,0,0,161
2017,성동구,경유,비사업용,24647,2482,8814,82,36025
2017,성동구,경유,사업용,991,396,1313,113,2813
2017,성동구,기타연료,비사업용,4,36,65,2,107
2017,성동구,기타연료,사업용,0,0,7,0,7
2017,성동구,엘피지,비사업용,4807,572,934,0,6313
2017,성동구,엘피지,사업용,2818,16,270,0,3104
2017,성동구,전기,비사업용,85,0,1,0,86
2017,성동구,전기,사업용,109,0,0,0,109
2017,성동구,하이브리드(LPG+전기),비사업용,69,0,0,0,69
2017,성동구,하이브리드(LPG+전기),사업용,2,0,0,0,2
2017,성동구,하이브리드(휘발유+전기),비사업용,1728,0,0,0,1728
2017,성동구,하이브리드(휘발유+전기),사업용,22,0,0,0,22
2017,성동구,휘발유,비사업용,22450,12,31,0,22493
2017,성동구,휘발유,사업용,489,5,0,0,494
2017,성동구,휘발유(무연),비사업용,27318,14,7,0,27339
2017,성동구,휘발유(무연),사업용,2179,0,0,0,2179
2017,성동구,휘발유(유연),비사업용,28,0,0,0,28
2017,광진구,CNG,비사업용,17,1,12,0,30
2017,광진구,CNG,사업용,0,367,0,0,367
2017,광진구,경유,비사업용,23499,2739,8769,24,35031
2017,광진구,경유,사업용,341,303,1179,176,1999
2017,광진구,기타연료,비사업용,0,29,82,2,113
2017,광진구,기타연료,사업용,0,0,5,0,5
2017,광진구,엘피지,비사업용,5139,692,884,1,6716
2017,광진구,엘피지,사업용,2520,3,269,60,2852
2017,광진구,전기,비사업용,43,0,0,0,43
2017,광진구,전기,사업용,1,0,0,0,1
2017,광진구,하이브리드(LPG+전기),비사업용,65,0,0,0,65
2017,광진구,하이브리드(휘발유+전기),비사업용,1533,0,0,0,1533
2017,광진구,하이브리드(휘발유+전기),사업용,4,0,0,0,4
2017,광진구,휘발유,비사업용,21364,10,23,0,21397
2017,광진구,휘발유,사업용,81,0,0,0,81
2017,광진구,휘발유(무연),비사업용,28038,25,25,0,28088
2017,광진구,휘발유(무연),사업용,261,0,0,0,261
2017,광진구,휘발유(유연),비사업용,45,0,0,0,45
2017,동대문구,CNG,비사업용,12,1,19,0,32
2017,동대문구,CNG,사업용,0,21,0,0,21
2017,동대문구,경유,비사업용,23124,3253,9876,67,36320
2017,동대문구,경유,사업용,245,173,1673,107,2198
2017,동대문구,기타연료,비사업용,3,36,96,2,137
2017,동대문구,기타연료,사업용,0,0,8,0,8
2017,동대문구,엘피지,비사업용,5703,728,1139,1,7571
2017,동대문구,엘피지,사업용,2487,2,370,0,2859
2017,동대문구,전기,비사업용,45,0,1,0,46
2017,동대문구,전기,사업용,3,0,0,0,3
2017,동대문구,하이브리드(LPG+전기),비사업용,68,0,0,0,68
2017,동대문구,하이브리드(휘발유+전기),비사업용,1170,0,0,0,1170
2017,동대문구,하이브리드(휘발유+전기),사업용,4,0,0,0,4
2017,동대문구,휘발유,비사업용,19582,9,34,0,19625
2017,동대문구,휘발유,사업용,81,0,0,0,81
2017,동대문구,휘발유(무연),비사업용,27005,26,28,0,27059
2017,동대문구,휘발유(무연),사업용,265,0,0,0,265
2017,동대문구,휘발유(유연),비사업용,40,0,0,0,40
2017,중랑구,CNG,비사업용,23,2,11,0,36
2017,중랑구,CNG,사업용,1,367,0,0,368
2017,중랑구,경유,비사업용,26431,3705,11489,84,41709
2017,중랑구,경유,사업용,225,192,2230,307,2954
2017,중랑구,기타연료,비사업용,2,32,79,4,117
2017,중랑구,기타연료,사업용,0,0,20,0,20
2017,중랑구,엘피지,비사업용,7630,972,1327,0,9929
2017,중랑구,엘피지,사업용,5568,1,406,0,5975
2017,중랑구,전기,비사업용,38,0,0,0,38
2017,중랑구,전기,사업용,2,0,0,0,2
2017,중랑구,하이브리드(LPG+전기),비사업용,63,0,0,0,63
2017,중랑구,하이브리드(경유+전기),비사업용,1,0,0,0,1
2017,중랑구,하이브리드(휘발유+전기),비사업용,1258,0,0,0,1258
2017,중랑구,하이브리드(휘발유+전기),사업용,6,0,0,0,6
2017,중랑구,휘발유,비사업용,20058,13,28,0,20099
2017,중랑구,휘발유,사업용,28,0,0,0,28
2017,중랑구,휘발유(무연),비사업용,30817,21,29,1,30868
2017,중랑구,휘발유(무연),사업용,414,0,0,0,414
2017,중랑구,휘발유(유연),비사업용,31,0,0,0,31
2017,성북구,CNG,비사업용,22,2,8,0,32
2017,성북구,CNG,사업용,2,779,0,0,781
2017,성북구,경유,비사업용,28998,3681,8556,44,41279
2017,성북구,경유,사업용,62,378,1245,78,1763
2017,성북구,기타연료,비사업용,3,39,129,1,172
2017,성북구,엘피지,비사업용,6915,829,984,2,8730
2017,성북구,엘피지,사업용,2530,2,333,0,2865
2017,성북구,전기,비사업용,64,0,0,0,64
2017,성북구,하이브리드(CNG+전기),사업용,0,3,0,0,3
2017,성북구,하이브리드(LPG+전기),비사업용,70,0,0,0,70
2017,성북구,하이브리드(휘발유+전기),비사업용,1745,0,0,0,1745
2017,성북구,하이브리드(휘발유+전기),사업용,2,0,0,0,2
2017,성북구,휘발유,비사업용,24868,10,32,0,24910
2017,성북구,휘발유,사업용,3,0,0,0,3
2017,성북구,휘발유(무연),비사업용,34664,22,24,0,34710
2017,성북구,휘발유(무연),사업용,36,0,0,0,36
2017,성북구,휘발유(유연),비사업용,44,0,0,0,44
2017,강북구,CNG,비사업용,10,1,13,0,24
2017,강북구,CNG,사업용,0,679,1,0,680
2017,강북구,경유,비사업용,18345,2730,7260,55,28390
2017,강북구,경유,사업용,11,60,929,94,1094
2017,강북구,기타연료,비사업용,1,5,43,0,49
2017,강북구,엘피지,비사업용,5635,767,888,0,7290
2017,강북구,엘피지,사업용,2592,1,255,0,2848
2017,강북구,전기,비사업용,24,0,0,0,24
2017,강북구,전기,사업용,3,0,0,0,3
2017,강북구,하이브리드(LPG+전기),비사업용,43,0,0,0,43
2017,강북구,하이브리드(경유+전기),비사업용,1,0,0,0,1
2017,강북구,하이브리드(휘발유+전기),비사업용,836,0,0,0,836
2017,강북구,하이브리드(휘발유+전기),사업용,4,0,0,0,4
2017,강북구,휘발유,비사업용,14067,10,20,0,14097
2017,강북구,휘발유,사업용,10,0,0,0,10
2017,강북구,휘발유(무연),비사업용,22269,15,7,0,22291
2017,강북구,휘발유(무연),사업용,108,0,0,0,108
2017,강북구,휘발유(유연),비사업용,28,0,0,0,28
2017,도봉구,CNG,비사업용,14,3,8,0,25
2017,도봉구,CNG,사업용,3,340,0,0,343
2017,도봉구,경유,비사업용,22311,2906,8214,64,33495
2017,도봉구,경유,사업용,51,80,1376,145,1652
2017,도봉구,기타연료,비사업용,1,33,61,0,95
2017,도봉구,기타연료,사업용,0,0,9,0,9
2017,도봉구,엘피지,비사업용,6541,741,909,0,8191
2017,도봉구,엘피지,사업용,5055,0,324,0,5379
2017,도봉구,전기,비사업용,43,0,0,0,43
2017,도봉구,전기,사업용,4,0,0,0,4
2017,도봉구,하이브리드(CNG+전기),사업용,0,8,0,0,8
2017,도봉구,하이브리드(LPG+전기),비사업용,86,0,0,0,86
2017,도봉구,하이브리드(휘발유+전기),비사업용,1163,0,0,0,1163
2017,도봉구,하이브리드(휘발유+전기),사업용,2,0,0,0,2
2017,도봉구,휘발유,비사업용,18336,5,21,0,18362
2017,도봉구,휘발유,사업용,20,0,0,0,20
2017,도봉구,휘발유(무연),비사업용,28303,13,15,0,28331
2017,도봉구,휘발유(무연),사업용,81,0,0,0,81
2017,도봉구,휘발유(유연),비사업용,34,0,0,0,34
2017,노원구,CNG,비사업용,38,3,10,0,51
2017,노원구,CNG,사업용,0,594,1,0,595
2017,노원구,경유,비사업용,36768,4222,10369,60,51419
2017,노원구,경유,사업용,93,361,1598,246,2298
2017,노원구,기타연료,비사업용,2,57,128,2,189
2017,노원구,기타연료,사업용,0,0,14,0,14
2017,노원구,엘피지,비사업용,11268,983,1183,1,13435
2017,노원구,엘피지,사업용,5896,4,356,0,6256
2017,노원구,전기,비사업용,79,1,0,0,80
2017,노원구,전기,사업용,3,0,0,0,3
2017,노원구,하이브리드(CNG+전기),사업용,0,31,0,0,31
2017,노원구,하이브리드(LPG+전기),비사업용,116,0,0,0,116
2017,노원구,하이브리드(경유+전기),비사업용,2,0,0,0,2
2017,노원구,하이브리드(휘발유+전기),비사업용,2192,0,0,0,2192
2017,노원구,하이브리드(휘발유+전기),사업용,3,0,0,0,3
2017,노원구,휘발유,비사업용,30867,8,31,0,30906
2017,노원구,휘발유,사업용,17,0,0,0,17
2017,노원구,휘발유(무연),비사업용,46819,27,18,0,46864
2017,노원구,휘발유(무연),사업용,174,0,0,0,174
2017,노원구,휘발유(유연),비사업용,62,0,0,0,62
2017,노원구,휘발유(유연),사업용,1,0,0,0,1
2017,은평구,CNG,비사업용,16,2,12,0,30
2017,은평구,CNG,사업용,5,719,0,0,724
2017,은평구,경유,비사업용,29861,3902,10500,64,44327
2017,은평구,경유,사업용,67,73,1585,177,1902
2017,은평구,기타연료,비사업용,3,30,95,9,137
2017,은평구,기타연료,사업용,0,0,1,0,1
2017,은평구,엘피지,비사업용,8382,985,1102,0,10469
2017,은평구,엘피지,사업용,3960,0,278,0,4238
2017,은평구,전기,비사업용,68,0,0,1,69
2017,은평구,전기,사업용,4,0,0,0,4
2017,은평구,하이브리드(CNG+전기),사업용,0,1,0,0,1
2017,은평구,하이브리드(LPG+전기),비사업용,102,0,0,0,102
2017,은평구,하이브리드(휘발유+전기),비사업용,1804,0,0,0,1804
2017,은평구,하이브리드(휘발유+전기),사업용,2,0,0,0,2
2017,은평구,휘발유,비사업용,26487,12,39,0,26538
2017,은평구,휘발유,사업용,8,0,1,0,9
2017,은평구,휘발유(무연),비사업용,38478,21,23,0,38522
2017,은평구,휘발유(무연),사업용,88,0,0,0,88
2017,은평구,휘발유(유연),비사업용,37,0,0,0,37
2017,서대문구,CNG,비사업용,12,10,15,0,37
2017,서대문구,CNG,사업용,4,277,0,0,281
2017,서대문구,경유,비사업용,19756,2658,6183,70,28667
2017,서대문구,경유,사업용,73,109,1622,228,2032
2017,서대문구,기타연료,비사업용,2,30,58,4,94
2017,서대문구,기타연료,사업용,0,0,41,0,41
2017,서대문구,엘피지,비사업용,4810,525,648,0,5983
2017,서대문구,엘피지,사업용,2765,2,144,0,2911
2017,서대문구,전기,비사업용,41,0,0,0,41
2017,서대문구,하이브리드(CNG+전기),사업용,0,2,0,0,2
2017,서대문구,하이브리드(LPG+전기),비사업용,67,0,0,0,67
2017,서대문구,하이브리드(경유+전기),비사업용,1,0,0,0,1
2017,서대문구,하이브리드(휘발유+전기),비사업용,1347,0,0,0,1347
2017,서대문구,하이브리드(휘발유+전기),사업용,3,0,0,0,3
2017,서대문구,휘발유,비사업용,18868,14,32,0,18914
2017,서대문구,휘발유,사업용,21,1,0,0,22
2017,서대문구,휘발유(무연),비사업용,25431,18,21,0,25470
2017,서대문구,휘발유(무연),사업용,121,0,0,0,121
2017,서대문구,휘발유(유연),비사업용,34,0,0,0,34
2017,마포구,CNG,비사업용,24,3,29,0,56
2017,마포구,CNG,사업용,0,292,0,0,292
2017,마포구,경유,비사업용,27246,3144,9148,116,39654
2017,마포구,경유,사업용,465,428,1798,119,2810
2017,마포구,기타연료,비사업용,2,38,105,2,147
2017,마포구,기타연료,사업용,0,0,46,0,46
2017,마포구,엘피지,비사업용,5323,708,963,0,6994
2017,마포구,엘피지,사업용,2484,1,168,0,2653
2017,마포구,전기,비사업용,88,0,0,0,88
2017,마포구,전기,사업용,122,0,0,0,122
2017,마포구,하이브리드(LPG+전기),비사업용,60,0,0,0,60
2017,마포구,하이브리드(휘발유+전기),비사업용,2061,0,0,0,2061
2017,마포구,하이브리드(휘발유+전기),사업용,12,0,0,0,12
2017,마포구,휘발유,비사업용,27162,19,53,2,27236
2017,마포구,휘발유,사업용,34,0,0,0,34
2017,마포구,휘발유(무연),비사업용,33453,29,42,0,33524
2017,마포구,휘발유(무연),사업용,708,0,0,0,708
2017,마포구,휘발유(유연),비사업용,34,0,0,0,34
2017,양천구,CNG,비사업용,28,2,18,0,48
2017,양천구,CNG,사업용,2,644,0,0,646
2017,양천구,경유,비사업용,34434,3818,11965,115,50332
2017,양천구,경유,사업용,64,180,2353,416,3013
2017,양천구,기타연료,비사업용,2,38,138,4,182
2017,양천구,기타연료,사업용,0,0,49,0,49
2017,양천구,엘피지,비사업용,8748,933,1203,1,10885
2017,양천구,엘피지,사업용,4661,2,248,0,4911
2017,양천구,전기,비사업용,78,0,1,0,79
2017,양천구,전기,사업용,14,0,0,0,14
2017,양천구,하이브리드(LPG+전기),비사업용,104,0,0,0,104
2017,양천구,하이브리드(경유+전기),비사업용,2,0,0,0,2
2017,양천구,하이브리드(휘발유+전기),비사업용,2329,0,0,0,2329
2017,양천구,하이브리드(휘발유+전기),사업용,2,0,0,0,2
2017,양천구,휘발유,비사업용,34100,11,25,0,34136
2017,양천구,휘발유,사업용,13,0,0,0,13
2017,양천구,휘발유(무연),비사업용,43908,20,34,0,43962
2017,양천구,휘발유(무연),사업용,77,0,0,0,77
2017,양천구,휘발유(유연),비사업용,39,0,0,0,39
2017,강서구,CNG,비사업용,37,8,17,0,62
2017,강서구,CNG,사업용,7,385,0,0,392
2017,강서구,경유,비사업용,45761,5308,16486,136,67691
2017,강서구,경유,사업용,326,919,2926,236,4407
2017,강서구,기타연료,비사업용,4,40,153,4,201
2017,강서구,기타연료,사업용,0,0,24,0,24
2017,강서구,엘피지,비사업용,12730,1285,1722,2,15739
2017,강서구,엘피지,사업용,7830,6,335,1,8172
2017,강서구,전기,비사업용,88,0,1,0,89
2017,강서구,전기,사업용,43,0,0,0,43
2017,강서구,하이브리드(LPG+전기),비사업용,138,0,0,0,138
2017,강서구,하이브리드(경유+전기),비사업용,1,0,0,0,1
2017,강서구,하이브리드(휘발유+전기),비사업용,2913,0,0,0,2913
2017,강서구,하이브리드(휘발유+전기),사업용,2292,0,0,0,2292
2017,강서구,휘발유,비사업용,41487,21,36,0,41544
2017,강서구,휘발유,사업용,93,0,0,0,93
2017,강서구,휘발유(무연),비사업용,57602,34,40,1,57677
2017,강서구,휘발유(무연),사업용,498,1,0,0,499
2017,강서구,휘발유(유연),비사업용,86,0,0,0,86
2017,구로구,CNG,비사업용,23,1,10,0,34
2017,구로구,CNG,사업용,3,346,0,0,349
2017,구로구,경유,비사업용,33438,5143,13730,135,52446
2017,구로구,경유,사업용,1557,363,2362,157,4439
2017,구로구,기타연료,비사업용,0,44,137,4,185
2017,구로구,기타연료,사업용,0,0,24,0,24
2017,구로구,엘피지,비사업용,8136,871,1110,1,10118
2017,구로구,엘피지,사업용,5454,3,278,0,5735
2017,구로구,전기,비사업용,65,0,0,0,65
2017,구로구,하이브리드(LPG+전기),비사업용,103,0,0,0,103
2017,구로구,하이브리드(휘발유+전기),비사업용,1909,0,0,0,1909
2017,구로구,하이브리드(휘발유+전기),사업용,157,0,0,0,157
2017,구로구,휘발유,비사업용,26857,14,37,0,26908
2017,구로구,휘발유,사업용,252,0,0,0,252
2017,구로구,휘발유(무연),비사업용,38568,20,29,0,38617
2017,구로구,휘발유(무연),사업용,2554,0,0,0,2554
2017,구로구,휘발유(유연),비사업용,40,0,0,0,40
2017,구로구,휘발유(유연),사업용,25,0,0,0,25
2017,금천구,CNG,비사업용,17,1,7,0,25
2017,금천구,CNG,사업용,0,387,0,0,387
2017,금천구,경유,비사업용,20533,3492,10280,55,34360
2017,금천구,경유,사업용,191,100,2090,83,2464
2017,금천구,기타연료,비사업용,1,18,57,1,77
2017,금천구,기타연료,사업용,0,0,38,0,38
2017,금천구,수소,비사업용,1,0,0,0,1
2017,금천구,엘피지,비사업용,4612,580,862,2,6056
2017,금천구,엘피지,사업용,3058,3,178,0,3239
2017,금천구,전기,비사업용,35,0,3,0,38
2017,금천구,전기,사업용,59,0,0,0,59
2017,금천구,하이브리드(LPG+전기),비사업용,72,0,0,0,72
2017,금천구,하이브리드(경유+전기),비사업용,0,1,0,0,1
2017,금천구,하이브리드(휘발유+전기),비사업용,1054,0,0,0,1054
2017,금천구,하이브리드(휘발유+전기),사업용,11,0,0,0,11
2017,금천구,휘발유,비사업용,14858,9,34,0,14901
2017,금천구,휘발유,사업용,14,0,0,0,14
2017,금천구,휘발유(무연),비사업용,23309,11,16,0,23336
2017,금천구,휘발유(무연),사업용,259,0,0,0,259
2017,금천구,휘발유(유연),비사업용,34,0,0,0,34
2017,금천구,휘발유(유연),사업용,1,0,0,0,1
2017,영등포구,CNG,비사업용,18,2,27,0,47
2017,영등포구,CNG,사업용,2,95,0,0,97
2017,영등포구,경유,비사업용,34844,4707,14579,485,54615
2017,영등포구,경유,사업용,416,270,3923,597,5206
2017,영등포구,기타연료,비사업용,4,37,138,4,183
2017,영등포구,기타연료,사업용,0,0,221,2,223
2017,영등포구,수소,비사업용,3,0,0,0,3
2017,영등포구,엘피지,비사업용,6529,1048,1156,4,8737
2017,영등포구,엘피지,사업용,2984,1,283,1,3269
2017,영등포구,전기,비사업용,174,0,0,0,174
2017,영등포구,전기,사업용,105,0,0,0,105
2017,영등포구,하이브리드(LPG+전기),비사업용,89,0,0,0,89
2017,영등포구,하이브리드(경유+전기),비사업용,2,0,0,0,2
2017,영등포구,하이브리드(휘발유+전기),비사업용,2553,0,0,0,2553
2017,영등포구,하이브리드(휘발유+전기),사업용,331,0,0,0,331
2017,영등포구,휘발유,비사업용,30490,19,51,0,30560
2017,영등포구,휘발유,사업용,39,0,0,0,39
2017,영등포구,휘발유(무연),비사업용,39318,32,42,0,39392
2017,영등포구,휘발유(무연),사업용,461,0,0,0,461
2017,영등포구,휘발유(유연),비사업용,60,0,0,0,60
2017,영등포구,휘발유(유연),사업용,4,0,0,0,4
2017,동작구,CNG,비사업용,11,0,7,0,18
2017,동작구,CNG,사업용,0,66,0,0,66
2017,동작구,경유,비사업용,25027,2823,7214,103,35167
2017,동작구,경유,사업용,29,64,959,301,1353
2017,동작구,기타연료,비사업용,2,28,51,2,83
2017,동작구,기타연료,사업용,0,0,4,0,4
2017,동작구,엘피지,비사업용,6111,647,754,1,7513
2017,동작구,엘피지,사업용,1193,0,140,0,1333
2017,동작구,전기,비사업용,70,0,2,0,72
2017,동작구,전기,사업용,1,0,0,0,1
2017,동작구,하이브리드(LPG+전기),비사업용,78,0,0,0,78
2017,동작구,하이브리드(휘발유+전기),비사업용,2021,0,0,0,2021
2017,동작구,하이브리드(휘발유+전기),사업용,2,0,0,0,2
2017,동작구,휘발유,비사업용,24728,13,18,0,24759
2017,동작구,휘발유,사업용,8,0,0,0,8
2017,동작구,휘발유(무연),비사업용,32254,11,22,0,32287
2017,동작구,휘발유(무연),사업용,36,0,0,0,36
2017,동작구,휘발유(유연),비사업용,36,0,0,0,36
2017,관악구,CNG,비사업용,16,9,13,1,39
2017,관악구,CNG,사업용,5,242,0,0,247
2017,관악구,경유,비사업용,28840,3914,9827,53,42634
2017,관악구,경유,사업용,136,47,1574,191,1948
2017,관악구,기타연료,비사업용,0,27,78,2,107
2017,관악구,기타연료,사업용,0,0,10,0,10
2017,관악구,엘피지,비사업용,7811,911,1080,0,9802
2017,관악구,엘피지,사업용,2853,1,288,0,3142
2017,관악구,전기,비사업용,45,0,0,0,45
2017,관악구,하이브리드(LPG+전기),비사업용,122,0,0,0,122
2017,관악구,하이브리드(경유+전기),비사업용,1,0,0,0,1
2017,관악구,하이브리드(휘발유+전기),비사업용,1889,0,0,0,1889
2017,관악구,하이브리드(휘발유+전기),사업용,5,0,0,0,5
2017,관악구,휘발유,비사업용,25257,13,33,0,25303
2017,관악구,휘발유,사업용,5,0,0,0,5
2017,관악구,휘발유(무연),비사업용,36567,18,29,0,36614
2017,관악구,휘발유(무연),사업용,130,0,0,0,130
2017,관악구,휘발유(유연),비사업용,60,0,0,0,60
2017,서초구,CNG,비사업용,34,2,28,1,65
2017,서초구,CNG,사업용,0,493,0,0,493
2017,서초구,경유,비사업용,38358,3819,11143,144,53464
2017,서초구,경유,사업용,2016,287,4994,174,7471
2017,서초구,기타연료,비사업용,11,80,193,14,298
2017,서초구,기타연료,사업용,0,0,92,0,92
2017,서초구,엘피지,비사업용,5232,729,888,1,6850
2017,서초구,엘피지,사업용,1952,3,90,0,2045
2017,서초구,전기,비사업용,303,0,0,0,303
2017,서초구,전기,사업용,5,0,0,0,5
2017,서초구,태양열,비사업용,1,0,0,0,1
2017,서초구,하이브리드(LPG+전기),비사업용,87,0,0,0,87
2017,서초구,하이브리드(경유+전기),비사업용,3,0,0,0,3
2017,서초구,하이브리드(휘발유+전기),비사업용,5143,0,0,0,5143
2017,서초구,하이브리드(휘발유+전기),사업용,57,0,0,0,57
2017,서초구,휘발유,비사업용,52131,50,61,2,52244
2017,서초구,휘발유,사업용,915,22,0,0,937
2017,서초구,휘발유(무연),비사업용,50797,39,43,1,50880
2017,서초구,휘발유(무연),사업용,1035,0,0,0,1035
2017,서초구,휘발유(유연),비사업용,73,0,0,0,73
2017,강남구,CNG,비사업용,58,1,35,0,94
2017,강남구,CNG,사업용,3,193,0,0,196
2017,강남구,경유,비사업용,50110,4554,13459,188,68311
2017,강남구,경유,사업용,2728,830,1718,172,5448
2017,강남구,기타연료,비사업용,12,87,162,16,277
2017,강남구,기타연료,사업용,0,0,283,0,283
2017,강남구,수소,비사업용,7,0,0,0,7
2017,강남구,엘피지,비사업용,6898,1032,1188,2,9120
2017,강남구,엘피지,사업용,5215,4,90,0,5309
2017,강남구,전기,비사업용,190,0,0,0,190
2017,강남구,전기,사업용,2195,0,0,0,2195
2017,강남구,하이브리드(LPG+전기),비사업용,133,0,0,0,133
2017,강남구,하이브리드(경유+전기),비사업용,3,0,0,0,3
2017,강남구,하이브리드(휘발유+전기),비사업용,7059,0,0,0,7059
2017,강남구,하이브리드(휘발유+전기),사업용,694,0,0,0,694
2017,강남구,휘발유,비사업용,69328,51,112,5,69496
2017,강남구,휘발유,사업용,506,1,0,0,507
2017,강남구,휘발유(무연),비사업용,63468,67,103,2,63640
2017,강남구,휘발유(무연),사업용,5264,0,0,0,5264
2017,강남구,휘발유(유연),비사업용,84,0,0,0,84
2017,강남구,휘발유(유연),사업용,1,0,0,0,1
2017,송파구,CNG,비사업용,53,0,50,0,103
2017,송파구,CNG,사업용,11,847,0,0,858
2017,송파구,경유,비사업용,52385,4884,19789,88,77146
2017,송파구,경유,사업용,389,702,3768,217,5076
2017,송파구,기타연료,비사업용,2,65,241,10,318
2017,송파구,기타연료,사업용,0,0,21,0,21
2017,송파구,엘피지,비사업용,10126,1123,1726,1,12976
2017,송파구,엘피지,사업용,5750,3,437,0,6190
2017,송파구,전기,비사업용,104,0,6,0,110
2017,송파구,전기,사업용,4,0,0,0,4
2017,송파구,하이브리드(CNG+전기),사업용,0,4,0,0,4
2017,송파구,하이브리드(LPG+전기),비사업용,159,0,0,0,159
2017,송파구,하이브리드(경유+전기),비사업용,3,0,0,0,3
2017,송파구,하이브리드(휘발유+전기),비사업용,4393,0,0,0,4393
2017,송파구,하이브리드(휘발유+전기),사업용,9,0,0,0,9
2017,송파구,휘발유,비사업용,56816,26,79,0,56921
2017,송파구,휘발유,사업용,56,0,0,0,56
2017,송파구,휘발유(무연),비사업용,66958,26,45,0,67029
2017,송파구,휘발유(무연),사업용,344,0,0,0,344
2017,송파구,휘발유(유연),비사업용,99,0,0,0,99
2017,강동구,CNG,비사업용,45,0,20,0,65
2017,강동구,CNG,사업용,5,197,0,0,202
2017,강동구,경유,비사업용,31507,3601,12054,55,47217
2017,강동구,경유,사업용,145,351,1987,243,2726
2017,강동구,기타연료,비사업용,5,39,109,4,157
2017,강동구,기타연료,사업용,0,0,46,0,46
2017,강동구,엘피지,비사업용,8533,931,1223,0,10687
2017,강동구,엘피지,사업용,4954,5,306,0,5265
2017,강동구,전기,비사업용,75,0,0,0,75
2017,강동구,전기,사업용,6,0,0,0,6
2017,강동구,하이브리드(CNG+전기),사업용,0,2,0,0,2
2017,강동구,하이브리드(LPG+전기),비사업용,88,0,0,0,88
2017,강동구,하이브리드(경유+전기),비사업용,1,0,0,0,1
2017,강동구,하이브리드(휘발유+전기),비사업용,2195,0,0,0,2195
2017,강동구,하이브리드(휘발유+전기),사업용,7,0,0,0,7
2017,강동구,휘발유,비사업용,28442,21,38,0,28501
2017,강동구,휘발유,사업용,32,12,0,0,44
2017,강동구,휘발유(무연),비사업용,39011,20,37,0,39068
2017,강동구,휘발유(무연),사업용,152,1,0,0,153
2017,강동구,휘발유(유연),비사업용,53,0,0,0,53
2018,합계,계,계,2658637,120780,337241,7993,3124651
2018,종로구,CNG,비사업용,6,2,16,0,24
2018,종로구,CNG,사업용,0,92,0,0,92
2018,종로구,경유,비사업용,11042,3268,4127,119,18556
2018,종로구,경유,사업용,54,223,598,53,928
2018,종로구,기타연료,비사업용,2,27,48,10,87
2018,종로구,기타연료,사업용,0,0,91,0,91
2018,종로구,수소,비사업용,6,0,0,0,6
2018,종로구,엘피지,비사업용,1763,241,350,0,2354
2018,종로구,엘피지,사업용,223,0,122,0,345
2018,종로구,전기,비사업용,129,0,4,0,133
2018,종로구,하이브리드(LPG+전기),비사업용,41,0,0,0,41
2018,종로구,하이브리드(경유+전기),비사업용,2,0,0,0,2
2018,종로구,하이브리드(휘발유+전기),비사업용,1241,0,0,0,1241
2018,종로구,하이브리드(휘발유+전기),사업용,9,0,0,0,9
2018,종로구,휘발유,비사업용,11604,38,49,1,11692
2018,종로구,휘발유,사업용,5,0,0,0,5
2018,종로구,휘발유(무연),비사업용,14877,28,15,1,14921
2018,종로구,휘발유(무연),사업용,196,0,0,0,196
2018,종로구,휘발유(유연),비사업용,9,0,0,0,9
2018,중구,CNG,비사업용,6,2,13,0,21
2018,중구,CNG,사업용,1,13,0,0,14
2018,중구,경유,비사업용,11932,2603,4887,78,19500
2018,중구,경유,사업용,666,275,1589,124,2654
2018,중구,기타연료,비사업용,5,23,82,17,127
2018,중구,기타연료,사업용,0,0,149,0,149
2018,중구,수소,비사업용,3,0,0,0,3
2018,중구,엘피지,비사업용,1455,328,431,0,2214
2018,중구,엘피지,사업용,892,1,59,0,952
2018,중구,전기,비사업용,182,2,2,0,186
2018,중구,전기,사업용,24,0,0,0,24
2018,중구,하이브리드(LPG+전기),비사업용,29,0,0,0,29
2018,중구,하이브리드(경유+전기),비사업용,3,0,0,0,3
2018,중구,하이브리드(휘발유+전기),비사업용,1049,0,0,0,1049
2018,중구,하이브리드(휘발유+전기),사업용,180,0,0,0,180
2018,중구,휘발유,비사업용,11246,18,19,2,11285
2018,중구,휘발유,사업용,190,5,0,0,195
2018,중구,휘발유(무연),비사업용,12554,16,29,0,12599
2018,중구,휘발유(무연),사업용,610,0,0,0,610
2018,중구,휘발유(유연),비사업용,19,0,0,0,19
2018,용산구,CNG,비사업용,3,1,25,1,30
2018,용산구,CNG,사업용,0,3,0,0,3
2018,용산구,경유,비사업용,18510,2020,5396,83,26009
2018,용산구,경유,사업용,67,65,1021,45,1198
2018,용산구,기타연료,비사업용,218,30,87,7,342
2018,용산구,기타연료,사업용,0,0,3,0,3
2018,용산구,엘피지,비사업용,2624,406,476,0,3506
2018,용산구,엘피지,사업용,765,16,77,0,858
2018,용산구,전기,비사업용,201,0,0,0,201
2018,용산구,하이브리드(LPG+전기),비사업용,35,0,0,0,35
2018,용산구,하이브리드(경유+전기),비사업용,1,0,0,0,1
2018,용산구,하이브리드(휘발유+전기),비사업용,1799,0,0,0,1799
2018,용산구,하이브리드(휘발유+전기),사업용,1,0,0,0,1
2018,용산구,휘발유,비사업용,22032,22,47,0,22101
2018,용산구,휘발유,사업용,31,5,0,0,36
2018,용산구,휘발유(무연),비사업용,21158,28,23,0,21209
2018,용산구,휘발유(무연),사업용,160,0,0,0,160
2018,용산구,휘발유(유연),비사업용,23,0,0,0,23
2018,성동구,CNG,비사업용,20,4,16,0,40
2018,성동구,CNG,사업용,0,160,0,0,160
2018,성동구,경유,비사업용,26044,2380,8593,73,37090
2018,성동구,경유,사업용,1000,868,1336,104,3308
2018,성동구,기타연료,비사업용,2,58,81,2,143
2018,성동구,기타연료,사업용,0,0,7,0,7
2018,성동구,수소,비사업용,3,0,0,0,3
2018,성동구,엘피지,비사업용,4454,556,827,0,5837
2018,성동구,엘피지,사업용,3087,19,267,0,3373
2018,성동구,전기,비사업용,175,0,2,0,177
2018,성동구,전기,사업용,264,0,0,0,264
2018,성동구,하이브리드(LPG+전기),비사업용,55,0,0,0,55
2018,성동구,하이브리드(LPG+전기),사업용,1,0,0,0,1
2018,성동구,하이브리드(휘발유+전기),비사업용,2297,0,0,0,2297
2018,성동구,하이브리드(휘발유+전기),사업용,19,0,0,0,19
2018,성동구,휘발유,비사업용,22642,12,33,0,22687
2018,성동구,휘발유,사업용,429,2,0,0,431
2018,성동구,휘발유(무연),비사업용,28019,16,6,0,28041
2018,성동구,휘발유(무연),사업용,2121,0,0,0,2121
2018,성동구,휘발유(유연),비사업용,40,0,0,0,40
2018,광진구,CNG,비사업용,16,1,13,0,30
2018,광진구,CNG,사업용,0,369,0,0,369
2018,광진구,경유,비사업용,23938,2557,10117,42,36654
2018,광진구,경유,사업용,448,327,1277,179,2231
2018,광진구,기타연료,비사업용,0,36,90,0,126
2018,광진구,기타연료,사업용,0,0,4,0,4
2018,광진구,엘피지,비사업용,4832,584,775,1,6192
2018,광진구,엘피지,사업용,2508,3,252,60,2823
2018,광진구,전기,비사업용,120,0,0,0,120
2018,광진구,전기,사업용,3,0,0,0,3
2018,광진구,하이브리드(LPG+전기),비사업용,61,0,0,0,61
2018,광진구,하이브리드(휘발유+전기),비사업용,1990,0,0,0,1990
2018,광진구,하이브리드(휘발유+전기),사업용,12,0,0,0,12
2018,광진구,휘발유,비사업용,20939,9,22,0,20970
2018,광진구,휘발유,사업용,244,1,0,0,245
2018,광진구,휘발유(무연),비사업용,28343,23,25,0,28391
2018,광진구,휘발유(무연),사업용,293,0,0,0,293
2018,광진구,휘발유(유연),비사업용,38,0,0,0,38
2018,동대문구,CNG,비사업용,15,1,19,0,35
2018,동대문구,CNG,사업용,0,21,0,0,21
2018,동대문구,경유,비사업용,23827,3071,9744,73,36715
2018,동대문구,경유,사업용,233,122,1748,101,2204
2018,동대문구,기타연료,비사업용,3,39,112,4,158
2018,동대문구,기타연료,사업용,0,0,7,0,7
2018,동대문구,수소,비사업용,2,0,0,0,2
2018,동대문구,엘피지,비사업용,5381,629,1061,2,7073
2018,동대문구,엘피지,사업용,2407,1,336,0,2744
2018,동대문구,전기,비사업용,103,0,1,0,104
2018,동대문구,전기,사업용,2,0,0,0,2
2018,동대문구,하이브리드(LPG+전기),비사업용,69,0,0,0,69
2018,동대문구,하이브리드(휘발유+전기),비사업용,1623,0,0,0,1623
2018,동대문구,하이브리드(휘발유+전기),사업용,39,0,0,0,39
2018,동대문구,휘발유,비사업용,19611,8,38,0,19657
2018,동대문구,휘발유,사업용,112,0,0,0,112
2018,동대문구,휘발유(무연),비사업용,27470,27,31,0,27528
2018,동대문구,휘발유(무연),사업용,191,0,0,0,191
2018,동대문구,휘발유(유연),비사업용,40,0,0,0,40
2018,중랑구,CNG,비사업용,22,2,12,0,36
2018,중랑구,CNG,사업용,1,360,0,0,361
2018,중랑구,경유,비사업용,27096,3520,11476,91,42183
2018,중랑구,경유,사업용,222,173,2389,323,3107
2018,중랑구,기타연료,비사업용,2,46,84,5,137
2018,중랑구,기타연료,사업용,0,0,17,0,17
2018,중랑구,수소,비사업용,1,0,0,0,1
2018,중랑구,엘피지,비사업용,7218,799,1188,0,9205
2018,중랑구,엘피지,사업용,5388,2,369,0,5759
2018,중랑구,전기,비사업용,124,0,0,0,124
2018,중랑구,전기,사업용,4,0,0,0,4
2018,중랑구,하이브리드(LPG+전기),비사업용,70,0,0,0,70
2018,중랑구,하이브리드(경유+전기),비사업용,1,0,0,0,1
2018,중랑구,하이브리드(휘발유+전기),비사업용,1569,0,0,0,1569
2018,중랑구,하이브리드(휘발유+전기),사업용,8,0,0,0,8
2018,중랑구,휘발유,비사업용,19861,11,35,0,19907
2018,중랑구,휘발유,사업용,24,0,0,0,24
2018,중랑구,휘발유(무연),비사업용,30995,17,31,1,31044
2018,중랑구,휘발유(무연),사업용,437,0,0,0,437
2018,중랑구,휘발유(유연),비사업용,28,0,0,0,28
2018,성북구,CNG,비사업용,18,3,7,0,28
2018,성북구,CNG,사업용,0,759,0,0,759
2018,성북구,경유,비사업용,29377,3448,8433,60,41318
2018,성북구,경유,사업용,67,372,1314,91,1844
2018,성북구,기타연료,비사업용,3,42,133,2,180
2018,성북구,기타연료,사업용,0,0,4,0,4
2018,성북구,수소,비사업용,2,0,0,0,2
2018,성북구,엘피지,비사업용,6334,681,836,0,7851
2018,성북구,엘피지,사업용,2516,3,304,0,2823
2018,성북구,전기,비사업용,149,0,0,0,149
2018,성북구,전기,사업용,6,19,0,0,25
2018,성북구,하이브리드(CNG+전기),사업용,0,3,0,0,3
2018,성북구,하이브리드(LPG+전기),비사업용,62,0,0,0,62
2018,성북구,하이브리드(휘발유+전기),비사업용,2269,0,0,0,2269
2018,성북구,하이브리드(휘발유+전기),사업용,2,0,0,0,2
2018,성북구,휘발유,비사업용,24409,13,32,0,24454
2018,성북구,휘발유,사업용,5,0,0,0,5
2018,성북구,휘발유(무연),비사업용,34652,19,15,0,34686
2018,성북구,휘발유(무연),사업용,38,0,0,0,38
2018,성북구,휘발유(유연),비사업용,41,0,0,0,41
2018,강북구,CNG,비사업용,14,1,8,0,23
2018,강북구,CNG,사업용,0,677,1,0,678
2018,강북구,경유,비사업용,18609,2614,7188,53,28464
2018,강북구,경유,사업용,23,62,1027,102,1214
2018,강북구,기타연료,비사업용,1,12,53,0,66
2018,강북구,기타연료,사업용,0,0,1,0,1
2018,강북구,수소,비사업용,1,0,0,0,1
2018,강북구,엘피지,비사업용,5339,647,806,0,6792
2018,강북구,엘피지,사업용,2527,0,231,0,2758
2018,강북구,전기,비사업용,79,0,0,0,79
2018,강북구,전기,사업용,6,0,0,0,6
2018,강북구,하이브리드(LPG+전기),비사업용,47,0,0,0,47
2018,강북구,하이브리드(경유+전기),비사업용,1,0,0,0,1
2018,강북구,하이브리드(휘발유+전기),비사업용,1101,0,0,0,1101
2018,강북구,하이브리드(휘발유+전기),사업용,2,0,0,0,2
2018,강북구,휘발유,비사업용,13936,11,19,1,13967
2018,강북구,휘발유,사업용,5,0,0,0,5
2018,강북구,휘발유(무연),비사업용,22034,15,10,0,22059
2018,강북구,휘발유(무연),사업용,75,0,0,0,75
2018,강북구,휘발유(유연),비사업용,26,0,0,0,26
2018,도봉구,CNG,비사업용,22,2,5,0,29
2018,도봉구,CNG,사업용,1,338,0,0,339
2018,도봉구,경유,비사업용,22758,2810,8255,71,33894
2018,도봉구,경유,사업용,60,88,1504,150,1802
2018,도봉구,기타연료,비사업용,1,39,76,0,116
2018,도봉구,기타연료,사업용,0,0,8,0,8
2018,도봉구,엘피지,비사업용,6257,620,817,1,7695
2018,도봉구,엘피지,사업용,4963,2,313,0,5278
2018,도봉구,전기,비사업용,105,0,0,0,105
2018,도봉구,전기,사업용,16,0,0,0,16
2018,도봉구,하이브리드(CNG+전기),사업용,0,8,0,0,8
2018,도봉구,하이브리드(LPG+전기),비사업용,66,0,0,0,66
2018,도봉구,하이브리드(휘발유+전기),비사업용,1548,0,0,0,1548
2018,도봉구,하이브리드(휘발유+전기),사업용,4,0,0,0,4
2018,도봉구,휘발유,비사업용,17953,7,24,0,17984
2018,도봉구,휘발유,사업용,48,0,0,0,48
2018,도봉구,휘발유(무연),비사업용,28212,14,18,0,28244
2018,도봉구,휘발유(무연),사업용,86,0,0,0,86
2018,도봉구,휘발유(유연),비사업용,38,0,0,0,38
2018,노원구,CNG,비사업용,34,3,7,0,44
2018,노원구,CNG,사업용,0,593,1,0,594
2018,노원구,경유,비사업용,36931,4010,10261,77,51279
2018,노원구,경유,사업용,100,291,1639,264,2294
2018,노원구,기타연료,비사업용,2,71,135,1,209
2018,노원구,기타연료,사업용,0,0,14,0,14
2018,노원구,수소,비사업용,1,0,0,0,1
2018,노원구,엘피지,비사업용,10562,830,1080,1,12473
2018,노원구,엘피지,사업용,5775,5,340,0,6120
2018,노원구,전기,비사업용,156,1,0,0,157
2018,노원구,전기,사업용,7,0,0,0,7
2018,노원구,하이브리드(CNG+전기),사업용,0,31,0,0,31
2018,노원구,하이브리드(LPG+전기),비사업용,104,0,0,0,104
2018,노원구,하이브리드(경유+전기),비사업용,2,0,0,0,2
2018,노원구,하이브리드(휘발유+전기),비사업용,2812,0,0,0,2812
2018,노원구,하이브리드(휘발유+전기),사업용,2,0,0,0,2
2018,노원구,휘발유,비사업용,30188,6,44,0,30238
2018,노원구,휘발유,사업용,51,0,0,0,51
2018,노원구,휘발유(무연),비사업용,46947,24,18,0,46989
2018,노원구,휘발유(무연),사업용,149,0,0,0,149
2018,노원구,휘발유(유연),비사업용,50,0,0,0,50
2018,은평구,CNG,비사업용,16,2,12,0,30
2018,은평구,CNG,사업용,4,719,0,0,723
2018,은평구,경유,비사업용,30638,3710,10328,77,44753
2018,은평구,경유,사업용,70,67,1713,183,2033
2018,은평구,기타연료,비사업용,2,42,113,7,164
2018,은평구,기타연료,사업용,0,0,1,0,1
2018,은평구,수소,비사업용,2,0,0,0,2
2018,은평구,엘피지,비사업용,7896,847,962,0,9705
2018,은평구,엘피지,사업용,4013,0,261,0,4274
2018,은평구,전기,비사업용,161,0,0,1,162
2018,은평구,전기,사업용,2,0,0,0,2
2018,은평구,하이브리드(CNG+전기),사업용,0,1,0,0,1
2018,은평구,하이브리드(LPG+전기),비사업용,104,0,0,0,104
2018,은평구,하이브리드(휘발유+전기),비사업용,2388,0,0,0,2388
2018,은평구,하이브리드(휘발유+전기),사업용,2,0,0,0,2
2018,은평구,휘발유,비사업용,26243,12,39,0,26294
2018,은평구,휘발유,사업용,6,0,1,0,7
2018,은평구,휘발유(무연),비사업용,38831,23,27,0,38881
2018,은평구,휘발유(무연),사업용,86,0,0,0,86
2018,은평구,휘발유(유연),비사업용,35,0,0,0,35
2018,서대문구,CNG,비사업용,12,10,15,0,37
2018,서대문구,CNG,사업용,2,280,0,0,282
2018,서대문구,경유,비사업용,20267,2492,6087,67,28913
2018,서대문구,경유,사업용,143,146,1661,240,2190
2018,서대문구,기타연료,비사업용,2,33,60,2,97
2018,서대문구,기타연료,사업용,0,0,42,0,42
2018,서대문구,수소,비사업용,3,0,0,0,3
2018,서대문구,엘피지,비사업용,4481,433,589,0,5503
2018,서대문구,엘피지,사업용,2749,5,134,0,2888
2018,서대문구,전기,비사업용,117,0,0,0,117
2018,서대문구,전기,사업용,11,0,0,0,11
2018,서대문구,하이브리드(CNG+전기),사업용,0,2,0,0,2
2018,서대문구,하이브리드(LPG+전기),비사업용,56,0,0,0,56
2018,서대문구,하이브리드(경유+전기),비사업용,1,0,0,0,1
2018,서대문구,하이브리드(휘발유+전기),비사업용,1824,0,0,0,1824
2018,서대문구,하이브리드(휘발유+전기),사업용,3,0,0,0,3
2018,서대문구,휘발유,비사업용,18672,14,33,0,18719
2018,서대문구,휘발유,사업용,24,1,0,0,25
2018,서대문구,휘발유(무연),비사업용,25787,15,22,0,25824
2018,서대문구,휘발유(무연),사업용,184,0,0,0,184
2018,서대문구,휘발유(유연),비사업용,32,0,0,0,32
2018,마포구,CNG,비사업용,25,2,30,0,57
2018,마포구,CNG,사업용,0,289,1,0,290
2018,마포구,경유,비사업용,27978,2951,9050,112,40091
2018,마포구,경유,사업용,566,457,1864,119,3006
2018,마포구,기타연료,비사업용,2,40,111,7,160
2018,마포구,기타연료,사업용,0,0,50,0,50
2018,마포구,수소,비사업용,2,0,0,0,2
2018,마포구,엘피지,비사업용,5061,634,900,0,6595
2018,마포구,엘피지,사업용,2634,1,140,0,2775
2018,마포구,전기,비사업용,207,0,0,0,207
2018,마포구,전기,사업용,9,0,0,0,9
2018,마포구,하이브리드(LPG+전기),비사업용,68,0,0,0,68
2018,마포구,하이브리드(휘발유+전기),비사업용,2756,0,0,0,2756
2018,마포구,하이브리드(휘발유+전기),사업용,15,0,0,0,15
2018,마포구,휘발유,비사업용,27104,21,58,2,27185
2018,마포구,휘발유,사업용,39,0,0,0,39
2018,마포구,휘발유(무연),비사업용,33852,24,41,0,33917
2018,마포구,휘발유(무연),사업용,731,0,0,0,731
2018,마포구,휘발유(유연),비사업용,38,0,0,0,38
2018,양천구,CNG,비사업용,24,2,18,0,44
2018,양천구,CNG,사업용,1,632,0,0,633
2018,양천구,경유,비사업용,35105,3611,11729,131,50576
2018,양천구,경유,사업용,60,147,2409,418,3034
2018,양천구,기타연료,비사업용,2,47,150,3,202
2018,양천구,기타연료,사업용,0,0,52,0,52
2018,양천구,수소,비사업용,1,0,0,0,1
2018,양천구,엘피지,비사업용,8298,797,1044,1,10140
2018,양천구,엘피지,사업용,4500,4,222,0,4726
2018,양천구,전기,비사업용,170,0,1,0,171
2018,양천구,전기,사업용,28,0,0,0,28
2018,양천구,하이브리드(LPG+전기),비사업용,95,0,0,0,95
2018,양천구,하이브리드(경유+전기),비사업용,2,0,0,0,2
2018,양천구,하이브리드(휘발유+전기),비사업용,3044,0,0,0,3044
2018,양천구,하이브리드(휘발유+전기),사업용,2,0,0,0,2
2018,양천구,휘발유,비사업용,33493,12,34,0,33539
2018,양천구,휘발유,사업용,13,0,0,0,13
2018,양천구,휘발유(무연),비사업용,44044,22,34,0,44100
2018,양천구,휘발유(무연),사업용,82,0,0,0,82
2018,양천구,휘발유(유연),비사업용,37,0,0,0,37
2018,강서구,CNG,비사업용,45,6,13,0,64
2018,강서구,CNG,사업용,4,390,0,0,394
2018,강서구,경유,비사업용,47097,5192,16283,155,68727
2018,강서구,경유,사업용,810,1064,3213,263,5350
2018,강서구,기타연료,비사업용,4,58,180,5,247
2018,강서구,기타연료,사업용,0,0,25,0,25
2018,강서구,수소,비사업용,2,0,0,0,2
2018,강서구,엘피지,비사업용,11961,1070,1529,1,14561
2018,강서구,엘피지,사업용,8088,17,310,2,8417
2018,강서구,전기,비사업용,200,0,1,0,201
2018,강서구,전기,사업용,73,0,0,0,73
2018,강서구,하이브리드(LPG+전기),비사업용,121,0,0,0,121
2018,강서구,하이브리드(경유+전기),비사업용,1,0,0,0,1
2018,강서구,하이브리드(휘발유+전기),비사업용,3914,0,0,0,3914
2018,강서구,하이브리드(휘발유+전기),사업용,2722,0,0,0,2722
2018,강서구,휘발유,비사업용,40551,23,45,0,40619
2018,강서구,휘발유,사업용,100,2,0,0,102
2018,강서구,휘발유(무연),비사업용,58192,32,38,1,58263
2018,강서구,휘발유(무연),사업용,574,1,0,0,575
2018,강서구,휘발유(유연),비사업용,88,0,0,0,88
2018,구로구,CNG,비사업용,27,2,9,0,38
2018,구로구,CNG,사업용,1,346,0,0,347
2018,구로구,경유,비사업용,33972,4969,13668,152,52761
2018,구로구,경유,사업용,1747,360,2446,191,4744
2018,구로구,기타연료,비사업용,0,43,156,4,203
2018,구로구,기타연료,사업용,0,0,30,0,30
2018,구로구,수소,비사업용,2,0,0,0,2
2018,구로구,엘피지,비사업용,7708,716,985,1,9410
2018,구로구,엘피지,사업용,5774,6,250,0,6030
2018,구로구,전기,비사업용,137,0,0,0,137
2018,구로구,전기,사업용,34,0,0,0,34
2018,구로구,하이브리드(LPG+전기),비사업용,100,0,0,0,100
2018,구로구,하이브리드(휘발유+전기),비사업용,2445,0,0,0,2445
2018,구로구,하이브리드(휘발유+전기),사업용,160,0,0,0,160
2018,구로구,휘발유,비사업용,25943,15,42,0,26000
2018,구로구,휘발유,사업용,268,0,0,0,268
2018,구로구,휘발유(무연),비사업용,38549,17,29,0,38595
2018,구로구,휘발유(무연),사업용,3072,0,0,0,3072
2018,구로구,휘발유(유연),비사업용,43,0,0,0,43
2018,구로구,휘발유(유연),사업용,21,0,0,0,21
2018,금천구,CNG,비사업용,19,2,6,0,27
2018,금천구,CNG,사업용,0,393,0,0,393
2018,금천구,경유,비사업용,21351,3440,10285,62,35138
2018,금천구,경유,사업용,211,97,2073,87,2468
2018,금천구,기타연료,비사업용,1,25,67,2,95
2018,금천구,기타연료,사업용,0,0,35,0,35
2018,금천구,수소,비사업용,1,0,0,0,1
2018,금천구,엘피지,비사업용,4362,492,757,1,5612
2018,금천구,엘피지,사업용,2558,3,181,0,2742
2018,금천구,전기,비사업용,93,0,3,0,96
2018,금천구,전기,사업용,38,0,0,0,38
2018,금천구,하이브리드(LPG+전기),비사업용,57,0,0,0,57
2018,금천구,하이브리드(LPG+전기),사업용,1,0,0,0,1
2018,금천구,하이브리드(경유+전기),비사업용,0,1,0,0,1
2018,금천구,하이브리드(휘발유+전기),비사업용,1370,0,0,0,1370
2018,금천구,하이브리드(휘발유+전기),사업용,22,0,0,0,22
2018,금천구,휘발유,비사업용,14620,10,36,0,14666
2018,금천구,휘발유,사업용,12,0,0,0,12
2018,금천구,휘발유(무연),비사업용,24024,9,14,0,24047
2018,금천구,휘발유(무연),사업용,203,1,0,0,204
2018,금천구,휘발유(유연),비사업용,37,0,0,0,37
2018,금천구,휘발유(유연),사업용,1,0,0,0,1
2018,영등포구,CNG,비사업용,12,3,27,0,42
2018,영등포구,CNG,사업용,1,95,0,0,96
2018,영등포구,경유,비사업용,34330,4499,14198,521,53548
2018,영등포구,경유,사업용,395,203,3738,624,4960
2018,영등포구,기타연료,비사업용,4,38,129,5,176
2018,영등포구,기타연료,사업용,0,0,213,2,215
2018,영등포구,수소,비사업용,4,0,0,0,4
2018,영등포구,엘피지,비사업용,6003,643,1029,4,7679
2018,영등포구,엘피지,사업용,2830,1,270,1,3102
2018,영등포구,전기,비사업용,381,0,0,0,381
2018,영등포구,전기,사업용,277,0,0,0,277
2018,영등포구,하이브리드(LPG+전기),비사업용,83,0,0,0,83
2018,영등포구,하이브리드(LPG+전기),사업용,8,0,0,0,8
2018,영등포구,하이브리드(휘발유+전기),비사업용,3090,0,0,0,3090
2018,영등포구,하이브리드(휘발유+전기),사업용,321,0,0,0,321
2018,영등포구,휘발유,비사업용,29777,18,60,0,29855
2018,영등포구,휘발유,사업용,44,0,0,0,44
2018,영등포구,휘발유(무연),비사업용,39418,26,37,0,39481
2018,영등포구,휘발유(무연),사업용,514,0,0,0,514
2018,영등포구,휘발유(유연),비사업용,60,0,0,0,60
2018,영등포구,휘발유(유연),사업용,4,0,0,0,4
2018,동작구,CNG,비사업용,14,0,6,0,20
2018,동작구,CNG,사업용,0,59,0,0,59
2018,동작구,경유,비사업용,25545,2740,6980,89,35354
2018,동작구,경유,사업용,33,74,1004,288,1399
2018,동작구,기타연료,비사업용,2,34,66,2,104
2018,동작구,기타연료,사업용,0,0,5,0,5
2018,동작구,수소,비사업용,1,0,0,0,1
2018,동작구,엘피지,비사업용,5736,536,671,1,6944
2018,동작구,엘피지,사업용,1152,0,141,0,1293
2018,동작구,전기,비사업용,150,0,2,0,152
2018,동작구,전기,사업용,5,0,0,0,5
2018,동작구,하이브리드(LPG+전기),비사업용,78,0,0,0,78
2018,동작구,하이브리드(경유+전기),비사업용,1,0,0,0,1
2018,동작구,하이브리드(휘발유+전기),비사업용,2615,0,0,0,2615
2018,동작구,하이브리드(휘발유+전기),사업용,3,0,0,0,3
2018,동작구,휘발유,비사업용,24453,15,22,0,24490
2018,동작구,휘발유,사업용,7,0,0,0,7
2018,동작구,휘발유(무연),비사업용,32831,13,20,0,32864
2018,동작구,휘발유(무연),사업용,40,0,0,0,40
2018,동작구,휘발유(유연),비사업용,42,0,0,0,42
2018,관악구,CNG,비사업용,23,9,11,1,44
2018,관악구,CNG,사업용,3,241,0,0,244
2018,관악구,경유,비사업용,29171,3774,9534,74,42553
2018,관악구,경유,사업용,144,42,1706,184,2076
2018,관악구,기타연료,비사업용,0,30,96,3,129
2018,관악구,기타연료,사업용,0,0,10,0,10
2018,관악구,수소,비사업용,1,0,0,0,1
2018,관악구,엘피지,비사업용,7304,755,981,0,9040
2018,관악구,엘피지,사업용,2813,1,281,0,3095
2018,관악구,전기,비사업용,147,0,0,0,147
2018,관악구,전기,사업용,2,0,0,0,2
2018,관악구,하이브리드(LPG+전기),비사업용,117,0,0,0,117
2018,관악구,하이브리드(경유+전기),비사업용,1,0,0,0,1
2018,관악구,하이브리드(휘발유+전기),비사업용,2419,0,0,0,2419
2018,관악구,하이브리드(휘발유+전기),사업용,8,0,0,0,8
2018,관악구,휘발유,비사업용,24624,13,35,0,24672
2018,관악구,휘발유,사업용,5,0,0,0,5
2018,관악구,휘발유(무연),비사업용,36640,19,32,0,36691
2018,관악구,휘발유(무연),사업용,120,0,0,0,120
2018,관악구,휘발유(유연),비사업용,56,0,0,0,56
2018,서초구,CNG,비사업용,33,3,28,1,65
2018,서초구,CNG,사업용,0,489,0,0,489
2018,서초구,경유,비사업용,39401,3593,10891,164,54049
2018,서초구,경유,사업용,2428,288,4886,171,7773
2018,서초구,기타연료,비사업용,7,83,189,13,292
2018,서초구,기타연료,사업용,0,0,84,0,84
2018,서초구,수소,비사업용,20,0,0,0,20
2018,서초구,수소,사업용,0,1,0,0,1
2018,서초구,엘피지,비사업용,4827,649,792,1,6269
2018,서초구,엘피지,사업용,1918,4,141,0,2063
2018,서초구,전기,비사업용,588,1,0,0,589
2018,서초구,전기,사업용,49,0,0,0,49
2018,서초구,하이브리드(LPG+전기),비사업용,73,0,0,0,73
2018,서초구,하이브리드(경유+전기),비사업용,3,0,0,0,3
2018,서초구,하이브리드(휘발유+전기),비사업용,6029,0,0,0,6029
2018,서초구,하이브리드(휘발유+전기),사업용,178,0,0,0,178
2018,서초구,휘발유,비사업용,51106,54,66,1,51227
2018,서초구,휘발유,사업용,1268,13,0,0,1281
2018,서초구,휘발유(무연),비사업용,50221,36,51,1,50309
2018,서초구,휘발유(무연),사업용,1206,0,0,0,1206
2018,서초구,휘발유(유연),비사업용,74,0,0,0,74
2018,강남구,CNG,비사업용,51,2,35,0,88
2018,강남구,CNG,사업용,2,193,0,0,195
2018,강남구,경유,비사업용,50548,4352,13024,204,68128
2018,강남구,경유,사업용,2765,702,1634,163,5264
2018,강남구,기타연료,비사업용,13,95,172,16,296
2018,강남구,기타연료,사업용,0,1,281,0,282
2018,강남구,수소,비사업용,18,0,0,0,18
2018,강남구,엘피지,비사업용,6173,892,1049,1,8115
2018,강남구,엘피지,사업용,4602,5,78,0,4685
2018,강남구,전기,비사업용,459,0,1,0,460
2018,강남구,전기,사업용,3802,0,0,0,3802
2018,강남구,하이브리드(LPG+전기),비사업용,112,0,0,0,112
2018,강남구,하이브리드(경유+전기),비사업용,3,0,0,0,3
2018,강남구,하이브리드(휘발유+전기),비사업용,8707,0,0,0,8707
2018,강남구,하이브리드(휘발유+전기),사업용,908,0,0,0,908
2018,강남구,휘발유,비사업용,67492,46,120,5,67663
2018,강남구,휘발유,사업용,466,1,0,0,467
2018,강남구,휘발유(무연),비사업용,61768,63,101,2,61934
2018,강남구,휘발유(무연),사업용,4105,0,0,0,4105
2018,강남구,휘발유(유연),비사업용,81,0,0,0,81
2018,강남구,휘발유(유연),사업용,1,0,0,0,1
2018,송파구,CNG,비사업용,52,0,39,0,91
2018,송파구,CNG,사업용,9,856,0,0,865
2018,송파구,경유,비사업용,54189,4597,20209,124,79119
2018,송파구,경유,사업용,481,720,4194,258,5653
2018,송파구,기타연료,비사업용,2,80,247,8,337
2018,송파구,기타연료,사업용,0,0,42,0,42
2018,송파구,수소,비사업용,4,0,0,0,4
2018,송파구,엘피지,비사업용,9670,996,1570,1,12237
2018,송파구,엘피지,사업용,5892,6,400,0,6298
2018,송파구,전기,비사업용,331,0,6,0,337
2018,송파구,전기,사업용,6,0,0,0,6
2018,송파구,하이브리드(CNG+전기),사업용,0,4,0,0,4
2018,송파구,하이브리드(LPG+전기),비사업용,151,0,0,0,151
2018,송파구,하이브리드(경유+전기),비사업용,6,0,0,0,6
2018,송파구,하이브리드(휘발유+전기),비사업용,5773,0,0,0,5773
2018,송파구,하이브리드(휘발유+전기),사업용,11,0,0,0,11
2018,송파구,휘발유,비사업용,56473,23,80,0,56576
2018,송파구,휘발유,사업용,78,0,0,0,78
2018,송파구,휘발유(무연),비사업용,67995,29,49,0,68073
2018,송파구,휘발유(무연),사업용,419,0,0,0,419
2018,송파구,휘발유(유연),비사업용,98,0,0,0,98
2018,송파구,휘발유(유연),사업용,1,0,0,0,1
2018,강동구,CNG,비사업용,37,1,21,0,59
2018,강동구,CNG,사업용,1,188,0,0,189
2018,강동구,경유,비사업용,31624,3392,11792,59,46867
2018,강동구,경유,사업용,207,344,2039,224,2814
2018,강동구,기타연료,비사업용,5,53,125,4,187
2018,강동구,기타연료,사업용,0,0,46,0,46
2018,강동구,수소,비사업용,3,0,0,0,3
2018,강동구,엘피지,비사업용,7911,807,1090,0,9808
2018,강동구,엘피지,사업용,5008,6,283,0,5297
2018,강동구,전기,비사업용,165,0,0,0,165
2018,강동구,전기,사업용,10,10,0,0,20
2018,강동구,하이브리드(CNG+전기),사업용,0,2,0,0,2
2018,강동구,하이브리드(LPG+전기),비사업용,76,0,0,0,76
2018,강동구,하이브리드(경유+전기),비사업용,1,0,0,0,1
2018,강동구,하이브리드(휘발유+전기),비사업용,2833,0,0,0,2833
2018,강동구,하이브리드(휘발유+전기),사업용,19,0,0,0,19
2018,강동구,휘발유,비사업용,27782,22,43,0,27847
2018,강동구,휘발유,사업용,37,0,0,0,37
2018,강동구,휘발유(무연),비사업용,38844,19,35,0,38898
2018,강동구,휘발유(무연),사업용,205,0,0,0,205
2018,강동구,휘발유(유연),비사업용,47,0,0,0,47
2019,합계,계,계,2670803,114310,330840,8204,3124157
2019,종로구,CNG,비사업용,6,4,20,0,30
2019,종로구,CNG,사업용,0,91,0,0,91
2019,종로구,경유,비사업용,10571,3142,3894,124,17731
2019,종로구,경유,사업용,58,223,631,46,958
2019,종로구,기타연료,비사업용,2,23,53,8,86
2019,종로구,기타연료,사업용,0,0,90,0,90
2019,종로구,수소,비사업용,26,2,0,0,28
2019,종로구,엘피지,비사업용,1637,221,316,0,2174
2019,종로구,엘피지,사업용,225,1,120,0,346
2019,종로구,전기,비사업용,182,0,4,0,186
2019,종로구,전기,사업용,3,0,0,0,3
2019,종로구,하이브리드(LPG+전기),비사업용,37,0,0,0,37
2019,종로구,하이브리드(경유+전기),비사업용,1,0,0,0,1
2019,종로구,하이브리드(휘발유+전기),비사업용,1503,0,0,0,1503
2019,종로구,하이브리드(휘발유+전기),사업용,8,0,0,0,8
2019,종로구,휘발유,비사업용,11288,37,57,1,11383
2019,종로구,휘발유,사업용,8,0,0,0,8
2019,종로구,휘발유(무연),비사업용,15141,28,15,1,15185
2019,종로구,휘발유(무연),사업용,194,0,0,0,194
2019,종로구,휘발유(유연),비사업용,10,0,0,0,10
2019,중구,CNG,비사업용,6,2,12,0,20
2019,중구,CNG,사업용,0,14,0,0,14
2019,중구,경유,비사업용,11658,2463,4749,86,18956
2019,중구,경유,사업용,660,367,1604,123,2754
2019,중구,기타연료,비사업용,4,27,81,15,127
2019,중구,기타연료,사업용,0,0,153,0,153
2019,중구,수소,비사업용,14,0,0,0,14
2019,중구,엘피지,비사업용,1394,298,416,0,2108
2019,중구,엘피지,사업용,831,1,57,0,889
2019,중구,전기,비사업용,282,2,4,0,288
2019,중구,전기,사업용,48,0,0,0,48
2019,중구,하이브리드(LPG+전기),비사업용,23,0,0,0,23
2019,중구,하이브리드(경유+전기),비사업용,15,0,0,0,15
2019,중구,하이브리드(휘발유+전기),비사업용,1333,0,0,0,1333
2019,중구,하이브리드(휘발유+전기),사업용,238,0,0,0,238
2019,중구,휘발유,비사업용,11175,16,23,0,11214
2019,중구,휘발유,사업용,144,0,0,0,144
2019,중구,휘발유(무연),비사업용,12707,12,29,0,12748
2019,중구,휘발유(무연),사업용,635,0,0,0,635
2019,중구,휘발유(유연),비사업용,15,0,0,0,15
2019,용산구,CNG,비사업용,3,1,26,0,30
2019,용산구,CNG,사업용,0,2,0,0,2
2019,용산구,경유,비사업용,18079,1909,5134,67,25189
2019,용산구,경유,사업용,124,66,999,41,1230
2019,용산구,기타연료,비사업용,138,31,95,5,269
2019,용산구,기타연료,사업용,0,0,3,0,3
2019,용산구,수소,비사업용,15,0,0,0,15
2019,용산구,엘피지,비사업용,2461,354,423,0,3238
2019,용산구,엘피지,사업용,671,18,71,0,760
2019,용산구,전기,비사업용,323,1,0,0,324
2019,용산구,전기,사업용,1,0,1,0,2
2019,용산구,하이브리드(LPG+전기),비사업용,31,0,0,0,31
2019,용산구,하이브리드(경유+전기),비사업용,1,0,0,0,1
2019,용산구,하이브리드(휘발유+전기),비사업용,2241,0,0,0,2241
2019,용산구,하이브리드(휘발유+전기),사업용,12,0,0,0,12
2019,용산구,휘발유,비사업용,21790,20,47,0,21857
2019,용산구,휘발유,사업용,36,3,0,0,39
2019,용산구,휘발유(무연),비사업용,21024,26,18,0,21068
2019,용산구,휘발유(무연),사업용,189,0,0,0,189
2019,용산구,휘발유(유연),비사업용,21,0,0,0,21
2019,성동구,CNG,비사업용,17,5,18,0,40
2019,성동구,CNG,사업용,0,455,0,0,455
2019,성동구,경유,비사업용,25225,2105,8287,80,35697
2019,성동구,경유,사업용,1081,2179,1376,100,4736
2019,성동구,기타연료,비사업용,2,67,94,1,164
2019,성동구,기타연료,사업용,1,0,5,0,6
2019,성동구,수소,비사업용,13,0,0,0,13
2019,성동구,엘피지,비사업용,4119,450,757,0,5326
2019,성동구,엘피지,사업용,2901,28,241,0,3170
2019,성동구,전기,비사업용,286,0,5,0,291
2019,성동구,전기,사업용,287,0,0,0,287
2019,성동구,하이브리드(LPG+전기),비사업용,54,0,0,0,54
2019,성동구,하이브리드(LPG+전기),사업용,20,0,0,0,20
2019,성동구,하이브리드(경유+전기),비사업용,3,0,0,0,3
2019,성동구,하이브리드(휘발유+전기),비사업용,2775,0,0,0,2775
2019,성동구,하이브리드(휘발유+전기),사업용,40,0,0,0,40
2019,성동구,휘발유,비사업용,21994,7,33,0,22034
2019,성동구,휘발유,사업용,205,4,0,0,209
2019,성동구,휘발유(무연),비사업용,28098,16,11,0,28125
2019,성동구,휘발유(무연),사업용,2780,0,0,0,2780
2019,성동구,휘발유(유연),비사업용,38,0,0,0,38
2019,광진구,CNG,비사업용,12,2,13,0,27
2019,광진구,CNG,사업용,0,167,0,0,167
2019,광진구,경유,비사업용,23259,2344,10066,34,35703
2019,광진구,경유,사업용,564,285,1280,178,2307
2019,광진구,기타연료,비사업용,0,42,87,0,129
2019,광진구,기타연료,사업용,0,0,4,0,4
2019,광진구,수소,비사업용,14,0,0,0,14
2019,광진구,수소,사업용,1,0,0,0,1
2019,광진구,엘피지,비사업용,4587,507,706,1,5801
2019,광진구,엘피지,사업용,2234,6,251,60,2551
2019,광진구,전기,비사업용,183,0,0,0,183
2019,광진구,전기,사업용,8,0,0,0,8
2019,광진구,하이브리드(LPG+전기),비사업용,59,0,0,0,59
2019,광진구,하이브리드(경유+전기),비사업용,3,0,0,0,3
2019,광진구,하이브리드(휘발유+전기),비사업용,2401,0,0,0,2401
2019,광진구,하이브리드(휘발유+전기),사업용,30,0,0,0,30
2019,광진구,휘발유,비사업용,20499,6,30,0,20535
2019,광진구,휘발유,사업용,251,1,0,0,252
2019,광진구,휘발유(무연),비사업용,28637,22,26,0,28685
2019,광진구,휘발유(무연),사업용,402,0,0,0,402
2019,광진구,휘발유(유연),비사업용,37,0,0,0,37
2019,동대문구,CNG,비사업용,10,1,18,0,29
2019,동대문구,CNG,사업용,0,21,0,0,21
2019,동대문구,경유,비사업용,23207,2907,9573,85,35772
2019,동대문구,경유,사업용,268,91,1803,90,2252
2019,동대문구,기타연료,비사업용,3,36,118,3,160
2019,동대문구,기타연료,사업용,0,0,7,0,7
2019,동대문구,수소,비사업용,9,0,0,0,9
2019,동대문구,엘피지,비사업용,5207,552,953,2,6714
2019,동대문구,엘피지,사업용,2195,5,330,0,2530
2019,동대문구,전기,비사업용,179,0,2,0,181
2019,동대문구,전기,사업용,13,0,1,0,14
2019,동대문구,하이브리드(LPG+전기),비사업용,57,0,0,0,57
2019,동대문구,하이브리드(휘발유+전기),비사업용,2055,0,0,0,2055
2019,동대문구,하이브리드(휘발유+전기),사업용,53,0,0,0,53
2019,동대문구,휘발유,비사업용,19313,7,44,0,19364
2019,동대문구,휘발유,사업용,160,0,0,0,160
2019,동대문구,휘발유(무연),비사업용,28261,27,26,0,28314
2019,동대문구,휘발유(무연),사업용,183,0,0,0,183
2019,동대문구,휘발유(유연),비사업용,35,0,0,0,35
2019,중랑구,CNG,비사업용,21,2,14,0,37
2019,중랑구,CNG,사업용,0,360,0,0,360
2019,중랑구,경유,비사업용,26182,3286,11184,107,40759
2019,중랑구,경유,사업용,210,175,2348,315,3048
2019,중랑구,기타연료,비사업용,2,45,90,6,143
2019,중랑구,기타연료,사업용,0,0,17,0,17
2019,중랑구,수소,비사업용,7,0,0,0,7
2019,중랑구,엘피지,비사업용,7007,711,1041,0,8759
2019,중랑구,엘피지,사업용,5321,28,355,0,5704
2019,중랑구,전기,비사업용,183,0,0,0,183
2019,중랑구,전기,사업용,29,0,0,0,29
2019,중랑구,하이브리드(LPG+전기),비사업용,56,0,0,0,56
2019,중랑구,하이브리드(경유+전기),비사업용,1,0,0,0,1
2019,중랑구,하이브리드(휘발유+전기),비사업용,1940,0,0,0,1940
2019,중랑구,하이브리드(휘발유+전기),사업용,12,0,0,0,12
2019,중랑구,휘발유,비사업용,19275,12,36,0,19323
2019,중랑구,휘발유,사업용,22,0,0,0,22
2019,중랑구,휘발유(무연),비사업용,31835,16,29,1,31881
2019,중랑구,휘발유(무연),사업용,413,0,0,0,413
2019,중랑구,휘발유(유연),비사업용,29,0,0,0,29
2019,성북구,CNG,비사업용,16,3,8,0,27
2019,성북구,CNG,사업용,0,744,0,0,744
2019,성북구,경유,비사업용,29352,3197,8326,76,40951
2019,성북구,경유,사업용,49,375,1360,105,1889
2019,성북구,기타연료,비사업용,2,43,134,3,182
2019,성북구,기타연료,사업용,0,0,4,0,4
2019,성북구,수소,비사업용,10,0,0,0,10
2019,성북구,엘피지,비사업용,6219,585,790,0,7594
2019,성북구,엘피지,사업용,2412,2,298,0,2712
2019,성북구,전기,비사업용,243,0,1,0,244
2019,성북구,전기,사업용,53,37,0,0,90
2019,성북구,하이브리드(CNG+전기),사업용,0,3,0,0,3
2019,성북구,하이브리드(LPG+전기),비사업용,66,0,0,0,66
2019,성북구,하이브리드(경유+전기),비사업용,2,0,0,0,2
2019,성북구,하이브리드(휘발유+전기),비사업용,2932,0,0,0,2932
2019,성북구,휘발유,비사업용,24860,16,42,0,24918
2019,성북구,휘발유,사업용,4,0,0,0,4
2019,성북구,휘발유(무연),비사업용,36842,21,17,0,36880
2019,성북구,휘발유(무연),사업용,35,0,0,0,35
2019,성북구,휘발유(유연),비사업용,34,0,0,0,34
2019,강북구,CNG,비사업용,14,1,8,0,23
2019,강북구,CNG,사업용,0,676,1,0,677
2019,강북구,경유,비사업용,17958,2441,7014,54,27467
2019,강북구,경유,사업용,34,43,1047,104,1228
2019,강북구,기타연료,비사업용,1,18,63,1,83
2019,강북구,기타연료,사업용,0,0,1,0,1
2019,강북구,수소,비사업용,2,0,0,0,2
2019,강북구,엘피지,비사업용,5065,558,710,0,6333
2019,강북구,엘피지,사업용,2364,3,215,0,2582
2019,강북구,전기,비사업용,123,0,0,0,123
2019,강북구,전기,사업용,29,0,1,0,30
2019,강북구,하이브리드(LPG+전기),비사업용,53,0,0,0,53
2019,강북구,하이브리드(LPG+전기),사업용,1,0,0,0,1
2019,강북구,하이브리드(경유+전기),비사업용,3,0,0,0,3
2019,강북구,하이브리드(휘발유+전기),비사업용,1370,0,0,0,1370
2019,강북구,휘발유,비사업용,13588,11,24,1,13624
2019,강북구,휘발유,사업용,4,0,0,0,4
2019,강북구,휘발유(무연),비사업용,22661,17,10,0,22688
2019,강북구,휘발유(무연),사업용,51,0,0,0,51
2019,강북구,휘발유(유연),비사업용,21,0,0,0,21
2019,도봉구,CNG,비사업용,18,2,5,0,25
2019,도봉구,CNG,사업용,0,339,0,0,339
2019,도봉구,경유,비사업용,22071,2620,8068,83,32842
2019,도봉구,경유,사업용,69,65,1543,153,1830
2019,도봉구,기타연료,비사업용,1,53,84,0,138
2019,도봉구,기타연료,사업용,0,0,8,0,8
2019,도봉구,수소,비사업용,9,0,0,0,9
2019,도봉구,엘피지,비사업용,6029,557,744,1,7331
2019,도봉구,엘피지,사업용,4779,17,302,0,5098
2019,도봉구,전기,비사업용,150,0,0,0,150
2019,도봉구,전기,사업용,51,0,0,0,51
2019,도봉구,하이브리드(CNG+전기),사업용,0,8,0,0,8
2019,도봉구,하이브리드(LPG+전기),비사업용,67,0,0,0,67
2019,도봉구,하이브리드(경유+전기),비사업용,2,0,0,0,2
2019,도봉구,하이브리드(휘발유+전기),비사업용,1811,0,0,0,1811
2019,도봉구,하이브리드(휘발유+전기),사업용,6,0,0,0,6
2019,도봉구,휘발유,비사업용,17506,10,28,0,17544
2019,도봉구,휘발유,사업용,53,0,0,0,53
2019,도봉구,휘발유(무연),비사업용,28985,14,17,0,29016
2019,도봉구,휘발유(무연),사업용,71,0,0,0,71
2019,도봉구,휘발유(유연),비사업용,36,0,0,0,36
2019,노원구,CNG,비사업용,28,4,6,0,38
2019,노원구,CNG,사업용,0,591,0,0,591
2019,노원구,경유,비사업용,35552,3699,10020,80,49351
2019,노원구,경유,사업용,123,295,1719,264,2401
2019,노원구,기타연료,비사업용,2,67,143,2,214
2019,노원구,기타연료,사업용,0,0,14,0,14
2019,노원구,수소,비사업용,10,0,0,0,10
2019,노원구,엘피지,비사업용,10117,703,928,1,11749
2019,노원구,엘피지,사업용,5757,6,336,0,6099
2019,노원구,전기,비사업용,236,1,0,0,237
2019,노원구,전기,사업용,26,0,0,0,26
2019,노원구,하이브리드(CNG+전기),사업용,0,31,0,0,31
2019,노원구,하이브리드(LPG+전기),비사업용,103,0,0,0,103
2019,노원구,하이브리드(경유+전기),비사업용,3,0,0,0,3
2019,노원구,하이브리드(휘발유+전기),비사업용,3485,0,0,0,3485
2019,노원구,하이브리드(휘발유+전기),사업용,2,0,0,0,2
2019,노원구,휘발유,비사업용,29290,7,42,0,29339
2019,노원구,휘발유,사업용,40,0,0,0,40
2019,노원구,휘발유(무연),비사업용,48047,25,16,0,48088
2019,노원구,휘발유(무연),사업용,197,0,0,0,197
2019,노원구,휘발유(유연),비사업용,53,0,0,0,53
2019,은평구,CNG,비사업용,14,2,12,0,28
2019,은평구,CNG,사업용,2,714,0,0,716
2019,은평구,경유,비사업용,29818,3423,10083,84,43408
2019,은평구,경유,사업용,62,57,1665,190,1974
2019,은평구,기타연료,비사업용,2,51,117,4,174
2019,은평구,기타연료,사업용,0,0,1,0,1
2019,은평구,수소,비사업용,30,0,0,0,30
2019,은평구,수소,사업용,5,0,0,0,5
2019,은평구,엘피지,비사업용,7594,724,864,0,9182
2019,은평구,엘피지,사업용,4014,7,246,0,4267
2019,은평구,전기,비사업용,217,0,0,1,218
2019,은평구,전기,사업용,42,0,0,0,42
2019,은평구,하이브리드(CNG+전기),사업용,0,1,0,0,1
2019,은평구,하이브리드(LPG+전기),비사업용,108,0,0,0,108
2019,은평구,하이브리드(경유+전기),비사업용,3,0,0,0,3
2019,은평구,하이브리드(휘발유+전기),비사업용,2980,0,0,0,2980
2019,은평구,하이브리드(휘발유+전기),사업용,2,0,0,0,2
2019,은평구,휘발유,비사업용,26069,13,44,0,26126
2019,은평구,휘발유,사업용,8,0,0,0,8
2019,은평구,휘발유(무연),비사업용,40378,22,27,0,40427
2019,은평구,휘발유(무연),사업용,80,0,0,0,80
2019,은평구,휘발유(유연),비사업용,40,0,0,0,40
2019,서대문구,CNG,비사업용,9,7,13,0,29
2019,서대문구,CNG,사업용,2,268,0,0,270
2019,서대문구,경유,비사업용,19776,2361,5877,76,28090
2019,서대문구,경유,사업용,272,162,1687,231,2352
2019,서대문구,기타연료,비사업용,2,44,66,1,113
2019,서대문구,기타연료,사업용,0,0,52,0,52
2019,서대문구,수소,비사업용,30,0,0,0,30
2019,서대문구,엘피지,비사업용,4296,356,530,0,5182
2019,서대문구,엘피지,사업용,2837,9,118,0,2964
2019,서대문구,전기,비사업용,191,0,0,0,191
2019,서대문구,전기,사업용,15,13,0,0,28
2019,서대문구,하이브리드(CNG+전기),사업용,0,2,0,0,2
2019,서대문구,하이브리드(LPG+전기),비사업용,57,0,0,0,57
2019,서대문구,하이브리드(경유+전기),비사업용,2,0,0,0,2
2019,서대문구,하이브리드(휘발유+전기),비사업용,2306,0,0,0,2306
2019,서대문구,하이브리드(휘발유+전기),사업용,6,0,0,0,6
2019,서대문구,휘발유,비사업용,18484,13,31,0,18528
2019,서대문구,휘발유,사업용,22,2,0,0,24
2019,서대문구,휘발유(무연),비사업용,26462,12,23,0,26497
2019,서대문구,휘발유(무연),사업용,347,0,0,0,347
2019,서대문구,휘발유(유연),비사업용,34,0,0,0,34
2019,마포구,CNG,비사업용,26,1,28,0,55
2019,마포구,CNG,사업용,0,279,1,0,280
2019,마포구,경유,비사업용,27363,2730,8881,122,39096
2019,마포구,경유,사업용,705,448,1838,129,3120
2019,마포구,기타연료,비사업용,2,51,129,7,189
2019,마포구,기타연료,사업용,0,0,50,0,50
2019,마포구,수소,비사업용,35,0,0,0,35
2019,마포구,엘피지,비사업용,4769,568,803,0,6140
2019,마포구,엘피지,사업용,2532,2,144,0,2678
2019,마포구,전기,비사업용,342,0,0,0,342
2019,마포구,전기,사업용,14,11,0,0,25
2019,마포구,하이브리드(LPG+전기),비사업용,65,0,0,0,65
2019,마포구,하이브리드(경유+전기),비사업용,2,0,0,0,2
2019,마포구,하이브리드(휘발유+전기),비사업용,3321,0,0,0,3321
2019,마포구,하이브리드(휘발유+전기),사업용,23,0,0,0,23
2019,마포구,휘발유,비사업용,26703,20,62,2,26787
2019,마포구,휘발유,사업용,73,0,0,0,73
2019,마포구,휘발유(무연),비사업용,34801,23,38,0,34862
2019,마포구,휘발유(무연),사업용,733,0,0,0,733
2019,마포구,휘발유(유연),비사업용,31,0,0,0,31
2019,양천구,CNG,비사업용,18,3,18,0,39
2019,양천구,CNG,사업용,0,621,0,0,621
2019,양천구,경유,비사업용,34079,3395,11337,153,48964
2019,양천구,경유,사업용,62,129,2596,414,3201
2019,양천구,기타연료,비사업용,2,54,147,3,206
2019,양천구,기타연료,사업용,0,0,50,0,50
2019,양천구,수소,비사업용,23,0,0,0,23
2019,양천구,수소,사업용,1,0,0,0,1
2019,양천구,엘피지,비사업용,8019,698,932,1,9650
2019,양천구,엘피지,사업용,4467,6,209,0,4682
2019,양천구,전기,비사업용,275,0,1,0,276
2019,양천구,전기,사업용,38,28,1,0,67
2019,양천구,하이브리드(LPG+전기),비사업용,90,0,0,0,90
2019,양천구,하이브리드(LPG+전기),사업용,3,0,0,0,3
2019,양천구,하이브리드(경유+전기),비사업용,1,0,0,0,1
2019,양천구,하이브리드(휘발유+전기),비사업용,3789,0,0,0,3789
2019,양천구,하이브리드(휘발유+전기),사업용,2,0,0,0,2
2019,양천구,휘발유,비사업용,32780,15,40,0,32835
2019,양천구,휘발유,사업용,10,0,0,0,10
2019,양천구,휘발유(무연),비사업용,44965,21,37,0,45023
2019,양천구,휘발유(무연),사업용,101,0,0,0,101
2019,양천구,휘발유(유연),비사업용,39,0,0,0,39
2019,강서구,CNG,비사업용,34,8,11,0,53
2019,강서구,CNG,사업용,2,384,0,0,386
2019,강서구,경유,비사업용,45854,4809,15839,167,66669
2019,강서구,경유,사업용,972,1037,3418,252,5679
2019,강서구,기타연료,비사업용,3,71,190,3,267
2019,강서구,기타연료,사업용,0,0,28,0,28
2019,강서구,수소,비사업용,24,0,0,0,24
2019,강서구,엘피지,비사업용,11524,950,1322,0,13796
2019,강서구,엘피지,사업용,7967,23,298,2,8290
2019,강서구,전기,비사업용,310,0,0,0,310
2019,강서구,전기,사업용,114,7,1,0,122
2019,강서구,하이브리드(LPG+전기),비사업용,107,0,0,0,107
2019,강서구,하이브리드(LPG+전기),사업용,1,0,0,0,1
2019,강서구,하이브리드(경유+전기),비사업용,4,0,0,0,4
2019,강서구,하이브리드(휘발유+전기),비사업용,4771,0,0,0,4771
2019,강서구,하이브리드(휘발유+전기),사업용,3341,0,0,0,3341
2019,강서구,휘발유,비사업용,39816,25,62,0,39903
2019,강서구,휘발유,사업용,133,2,0,0,135
2019,강서구,휘발유(무연),비사업용,59904,31,39,1,59975
2019,강서구,휘발유(무연),사업용,736,1,0,0,737
2019,강서구,휘발유(유연),비사업용,77,0,0,0,77
2019,구로구,CNG,비사업용,30,3,10,0,43
2019,구로구,CNG,사업용,1,346,0,0,347
2019,구로구,경유,비사업용,33483,4718,13600,171,51972
2019,구로구,경유,사업용,1515,372,2480,191,4558
2019,구로구,기타연료,비사업용,0,48,163,4,215
2019,구로구,기타연료,사업용,0,0,29,0,29
2019,구로구,수소,비사업용,23,0,0,0,23
2019,구로구,엘피지,비사업용,7540,628,897,1,9066
2019,구로구,엘피지,사업용,5506,8,262,0,5776
2019,구로구,전기,비사업용,210,0,1,0,211
2019,구로구,전기,사업용,55,0,1,0,56
2019,구로구,하이브리드(LPG+전기),비사업용,101,0,0,0,101
2019,구로구,하이브리드(LPG+전기),사업용,3,0,0,0,3
2019,구로구,하이브리드(휘발유+전기),비사업용,3052,0,0,0,3052
2019,구로구,하이브리드(휘발유+전기),사업용,129,0,0,0,129
2019,구로구,휘발유,비사업용,25370,14,47,0,25431
2019,구로구,휘발유,사업용,264,0,0,0,264
2019,구로구,휘발유(무연),비사업용,40394,19,28,0,40441
2019,구로구,휘발유(무연),사업용,2704,0,0,0,2704
2019,구로구,휘발유(유연),비사업용,41,0,0,0,41
2019,구로구,휘발유(유연),사업용,3,0,0,0,3
2019,금천구,CNG,비사업용,17,2,4,0,23
2019,금천구,CNG,사업용,0,395,0,0,395
2019,금천구,경유,비사업용,21130,3182,10178,70,34560
2019,금천구,경유,사업용,247,94,2118,83,2542
2019,금천구,기타연료,비사업용,1,26,71,2,100
2019,금천구,기타연료,사업용,0,0,37,0,37
2019,금천구,수소,비사업용,11,0,0,0,11
2019,금천구,수소,사업용,1,0,0,0,1
2019,금천구,엘피지,비사업용,4208,448,673,1,5330
2019,금천구,엘피지,사업용,2470,3,180,0,2653
2019,금천구,전기,비사업용,261,0,6,0,267
2019,금천구,전기,사업용,62,0,1,0,63
2019,금천구,하이브리드(LPG+전기),비사업용,60,0,0,0,60
2019,금천구,하이브리드(LPG+전기),사업용,5,0,0,0,5
2019,금천구,하이브리드(경유+전기),비사업용,1,1,0,0,2
2019,금천구,하이브리드(휘발유+전기),비사업용,1698,0,0,0,1698
2019,금천구,하이브리드(휘발유+전기),사업용,26,0,0,0,26
2019,금천구,휘발유,비사업용,14346,10,41,1,14398
2019,금천구,휘발유,사업용,19,0,0,0,19
2019,금천구,휘발유(무연),비사업용,25085,8,16,0,25109
2019,금천구,휘발유(무연),사업용,245,0,0,0,245
2019,금천구,휘발유(유연),비사업용,36,0,0,0,36
2019,금천구,휘발유(유연),사업용,1,0,0,0,1
2019,영등포구,CNG,비사업용,10,3,26,0,39
2019,영등포구,CNG,사업용,1,75,0,0,76
2019,영등포구,경유,비사업용,32302,4195,13608,590,50695
2019,영등포구,경유,사업용,544,153,3720,618,5035
2019,영등포구,기타연료,비사업용,4,47,135,3,189
2019,영등포구,기타연료,사업용,0,0,207,2,209
2019,영등포구,수소,비사업용,28,0,0,0,28
2019,영등포구,수소,사업용,5,0,0,0,5
2019,영등포구,엘피지,비사업용,5886,535,939,6,7366
2019,영등포구,엘피지,사업용,2591,2,267,0,2860
2019,영등포구,전기,비사업용,472,0,493,0,965
2019,영등포구,전기,사업용,397,0,0,0,397
2019,영등포구,하이브리드(LPG+전기),비사업용,78,0,0,0,78
2019,영등포구,하이브리드(LPG+전기),사업용,28,0,0,0,28
2019,영등포구,하이브리드(경유+전기),비사업용,4,0,0,0,4
2019,영등포구,하이브리드(휘발유+전기),비사업용,3713,0,0,0,3713
2019,영등포구,하이브리드(휘발유+전기),사업용,194,0,0,0,194
2019,영등포구,휘발유,비사업용,28810,18,58,0,28886
2019,영등포구,휘발유,사업용,43,0,0,0,43
2019,영등포구,휘발유(무연),비사업용,40303,20,40,0,40363
2019,영등포구,휘발유(무연),사업용,776,0,0,0,776
2019,영등포구,휘발유(유연),비사업용,61,0,0,0,61
2019,동작구,CNG,비사업용,15,0,4,0,19
2019,동작구,CNG,사업용,0,53,0,0,53
2019,동작구,경유,비사업용,25001,2500,6765,93,34359
2019,동작구,경유,사업용,13,82,1024,277,1396
2019,동작구,기타연료,비사업용,2,35,69,2,108
2019,동작구,기타연료,사업용,0,0,5,0,5
2019,동작구,수소,비사업용,15,0,0,0,15
2019,동작구,엘피지,비사업용,5591,469,627,1,6688
2019,동작구,엘피지,사업용,1112,0,134,0,1246
2019,동작구,전기,비사업용,248,0,2,0,250
2019,동작구,전기,사업용,15,0,0,0,15
2019,동작구,하이브리드(LPG+전기),비사업용,70,0,0,0,70
2019,동작구,하이브리드(LPG+전기),사업용,1,0,0,0,1
2019,동작구,하이브리드(경유+전기),비사업용,2,0,0,0,2
2019,동작구,하이브리드(휘발유+전기),비사업용,3179,0,0,0,3179
2019,동작구,하이브리드(휘발유+전기),사업용,1,0,0,0,1
2019,동작구,휘발유,비사업용,24157,13,27,1,24198
2019,동작구,휘발유(무연),비사업용,33784,12,21,0,33817
2019,동작구,휘발유(무연),사업용,12,0,0,0,12
2019,동작구,휘발유(유연),비사업용,38,0,0,0,38
2019,관악구,CNG,비사업용,16,10,9,1,36
2019,관악구,CNG,사업용,3,231,0,0,234
2019,관악구,경유,비사업용,28236,3539,9183,92,41050
2019,관악구,경유,사업용,176,47,1758,175,2156
2019,관악구,기타연료,비사업용,0,27,96,1,124
2019,관악구,기타연료,사업용,0,0,11,0,11
2019,관악구,수소,비사업용,11,0,0,0,11
2019,관악구,엘피지,비사업용,7055,629,897,1,8582
2019,관악구,엘피지,사업용,2833,3,261,0,3097
2019,관악구,전기,비사업용,216,0,1,0,217
2019,관악구,전기,사업용,22,11,0,0,33
2019,관악구,하이브리드(LPG+전기),비사업용,111,0,0,0,111
2019,관악구,하이브리드(경유+전기),비사업용,2,0,0,0,2
2019,관악구,하이브리드(휘발유+전기),비사업용,2957,0,0,0,2957
2019,관악구,하이브리드(휘발유+전기),사업용,12,0,0,0,12
2019,관악구,휘발유,비사업용,23734,13,34,0,23781
2019,관악구,휘발유,사업용,10,0,0,0,10
2019,관악구,휘발유(무연),비사업용,37370,16,28,0,37414
2019,관악구,휘발유(무연),사업용,163,0,0,0,163
2019,관악구,휘발유(유연),비사업용,49,0,0,0,49
2019,서초구,CNG,비사업용,26,4,31,1,62
2019,서초구,CNG,사업용,0,487,0,0,487
2019,서초구,경유,비사업용,38472,3318,10554,169,52513
2019,서초구,경유,사업용,2223,280,4785,161,7449
2019,서초구,기타연료,비사업용,6,86,192,17,301
2019,서초구,기타연료,사업용,0,0,89,0,89
2019,서초구,수소,비사업용,77,0,0,0,77
2019,서초구,수소,사업용,7,0,0,0,7
2019,서초구,엘피지,비사업용,4731,579,747,1,6058
2019,서초구,엘피지,사업용,1834,10,139,0,1983
2019,서초구,전기,비사업용,1027,1,55,0,1083
2019,서초구,전기,사업용,69,0,0,0,69
2019,서초구,하이브리드(LPG+전기),비사업용,69,0,0,0,69
2019,서초구,하이브리드(경유+전기),비사업용,5,0,0,0,5
2019,서초구,하이브리드(휘발유+전기),비사업용,6695,0,0,0,6695
2019,서초구,하이브리드(휘발유+전기),사업용,266,0,0,0,266
2019,서초구,휘발유,비사업용,50058,53,76,1,50188
2019,서초구,휘발유,사업용,1537,4,0,0,1541
2019,서초구,휘발유(무연),비사업용,50816,29,54,1,50900
2019,서초구,휘발유(무연),사업용,1270,0,0,0,1270
2019,서초구,휘발유(유연),비사업용,70,0,0,0,70
2019,강남구,CNG,비사업용,44,3,34,0,81
2019,강남구,CNG,사업용,0,195,0,0,195
2019,강남구,경유,비사업용,50102,4065,12382,218,66767
2019,강남구,경유,사업용,2102,544,1657,163,4466
2019,강남구,기타연료,비사업용,13,103,187,17,320
2019,강남구,기타연료,사업용,0,0,278,0,278
2019,강남구,수소,비사업용,72,0,0,0,72
2019,강남구,수소,사업용,1,0,0,0,1
2019,강남구,엘피지,비사업용,6039,822,991,1,7853
2019,강남구,엘피지,사업용,4080,116,76,0,4272
2019,강남구,전기,비사업용,934,0,1,0,935
2019,강남구,전기,사업용,4821,0,0,0,4821
2019,강남구,하이브리드(LPG+전기),비사업용,98,0,0,0,98
2019,강남구,하이브리드(경유+전기),비사업용,16,0,0,0,16
2019,강남구,하이브리드(휘발유+전기),비사업용,10362,0,0,0,10362
2019,강남구,하이브리드(휘발유+전기),사업용,1188,0,0,0,1188
2019,강남구,휘발유,비사업용,67513,45,120,5,67683
2019,강남구,휘발유,사업용,323,1,0,0,324
2019,강남구,휘발유(무연),비사업용,62117,54,105,2,62278
2019,강남구,휘발유(무연),사업용,3316,0,0,0,3316
2019,강남구,휘발유(유연),비사업용,87,0,0,0,87
2019,강남구,휘발유(유연),사업용,2,0,0,0,2
2019,송파구,CNG,비사업용,55,0,30,0,85
2019,송파구,CNG,사업용,2,762,0,0,764
2019,송파구,경유,비사업용,54217,4285,20398,141,79041
2019,송파구,경유,사업용,419,726,4375,270,5790
2019,송파구,기타연료,비사업용,2,100,274,6,382
2019,송파구,기타연료,사업용,0,0,57,0,57
2019,송파구,수소,비사업용,46,0,0,0,46
2019,송파구,엘피지,비사업용,9475,883,1405,2,11765
2019,송파구,엘피지,사업용,5633,12,367,0,6012
2019,송파구,전기,비사업용,572,0,9,0,581
2019,송파구,전기,사업용,36,0,0,0,36
2019,송파구,하이브리드(CNG+전기),사업용,0,4,0,0,4
2019,송파구,하이브리드(LPG+전기),비사업용,154,0,0,0,154
2019,송파구,하이브리드(경유+전기),비사업용,9,0,0,0,9
2019,송파구,하이브리드(휘발유+전기),비사업용,7463,0,0,0,7463
2019,송파구,하이브리드(휘발유+전기),사업용,10,0,0,0,10
2019,송파구,휘발유,비사업용,56914,23,84,0,57021
2019,송파구,휘발유,사업용,82,1,0,0,83
2019,송파구,휘발유(무연),비사업용,70629,27,48,0,70704
2019,송파구,휘발유(무연),사업용,444,0,0,0,444
2019,송파구,휘발유(유연),비사업용,106,0,0,0,106
2019,송파구,휘발유(유연),사업용,2,0,0,0,2
2019,강동구,CNG,비사업용,31,0,20,0,51
2019,강동구,CNG,사업용,1,186,0,0,187
2019,강동구,경유,비사업용,31984,3205,11781,64,47034
2019,강동구,경유,사업용,274,339,2097,223,2933
2019,강동구,기타연료,비사업용,6,67,143,3,219
2019,강동구,기타연료,사업용,0,0,43,0,43
2019,강동구,수소,비사업용,22,0,0,0,22
2019,강동구,엘피지,비사업용,7905,749,991,0,9645
2019,강동구,엘피지,사업용,5049,14,263,0,5326
2019,강동구,전기,비사업용,272,0,0,0,272
2019,강동구,전기,사업용,67,15,0,0,82
2019,강동구,하이브리드(CNG+전기),사업용,0,2,0,0,2
2019,강동구,하이브리드(LPG+전기),비사업용,73,0,0,0,73
2019,강동구,하이브리드(경유+전기),비사업용,1,0,0,0,1
2019,강동구,하이브리드(휘발유+전기),비사업용,3695,0,0,0,3695
2019,강동구,하이브리드(휘발유+전기),사업용,30,0,0,0,30
2019,강동구,휘발유,비사업용,28180,19,55,0,28254
2019,강동구,휘발유,사업용,70,3,0,0,73
2019,강동구,휘발유(무연),비사업용,41276,19,28,0,41323
2019,강동구,휘발유(무연),사업용,232,0,0,0,232
2019,강동구,휘발유(유연),비사업용,52,0,0,0,52
